task_name,instance_num,job_name,task_type,status,start_time,end_time,duration,plan_cpu,plan_mem
1745,17,340,3,Terminated,4909,5006,97,100,0.5404705821447979
1742,27,340,3,Terminated,4909,5026,117,100,0.5404705821447979
1744,37,340,3,Terminated,4909,5049,140,100,0.5404705821447979
1758,10,342,10,Terminated,6247,6437,190,75,1.63383635751818
1800,11,352,10,Terminated,15220,15398,178,40,0.416224471306913
3105,51,579,12,Terminated,14340,14379,39,100,0.5404705821447979
3261,51,624,12,Terminated,36451,36507,56,100,0.5404705821447979
3298,51,633,8,Terminated,39988,40031,43,100,0.5404705821447979
3433,51,675,10,Terminated,56702,56734,32,100,0.5404705821447979
5167,31,994,3,Terminated,19503,19619,116,100,0.5404705821447979
5169,31,994,3,Terminated,19503,19642,139,100,0.5404705821447979
5764,80,1040,3,Terminated,24494,24630,136,100,0.5404705821447979
5765,65,1040,3,Terminated,24494,24669,175,100,0.5404705821447979
5767,35,1040,3,Terminated,24494,24536,42,100,0.5404705821447979
5761,43,1040,3,Terminated,24494,24562,68,100,0.5404705821447979
5776,35,1040,3,Terminated,24494,24552,58,100,0.5404705821447979
5899,62,1064,12,Terminated,34972,35036,64,100,0.5404705821447979
5900,87,1064,12,Terminated,34972,35020,48,100,0.5404705821447979
9007,15,1657,3,Terminated,7523,7637,114,40,0.8107058732171971
9597,47,1757,12,Terminated,2189,2303,114,100,0.5404705821447979
9607,23,1759,8,Terminated,3353,3489,136,100,0.5404705821447979
9606,11,1759,8,Terminated,3353,3487,134,100,0.5404705821447979
9617,23,1759,8,Terminated,3353,3490,137,100,0.5404705821447979
10163,16,1845,10,Terminated,14224,14278,54,100,0.5404705821447979
10181,21,1851,3,Terminated,15647,15692,45,100,0.5404705821447979
10180,11,1851,3,Terminated,15647,15689,42,100,0.5404705821447979
10374,16,1876,8,Terminated,37614,37672,58,100,0.5404705821447979
10493,35,1891,8,Terminated,48296,48341,45,100,0.5404705821447979
10496,19,1891,8,Terminated,48296,48338,42,100,0.5404705821447979
10497,29,1891,8,Terminated,48296,48340,44,100,0.5404705821447979
11108,18,1968,12,Terminated,6059,6079,20,40,0.782750498278673
11298,12,2003,10,Terminated,21997,22184,187,100,0.275412212357311
11729,13,2078,8,Terminated,30674,30741,67,100,0.5404705821447979
11730,15,2078,8,Terminated,30674,30743,69,100,0.5404705821447979
11734,19,2079,3,Terminated,31567,31683,116,100,0.5404705821447979
11733,17,2079,3,Terminated,31567,31683,116,100,0.5404705821447979
11758,35,2085,3,Terminated,36977,37081,104,100,0.5404705821447979
11757,33,2085,3,Terminated,36977,37080,103,100,0.5404705821447979
11774,43,2089,10,Terminated,40574,40662,88,100,0.5404705821447979
11773,41,2089,10,Terminated,40574,40661,87,100,0.5404705821447979
11778,53,2090,8,Terminated,41490,41665,175,100,0.5404705821447979
11777,51,2090,8,Terminated,41490,41664,174,100,0.5404705821447979
12155,11,2166,10,Terminated,45974,46039,65,100,0.5404705821447979
12421,15,2206,3,Terminated,9872,9909,37,100,0.5404705821447979
12420,13,2206,3,Terminated,9872,9902,30,100,0.5404705821447979
12422,17,2206,3,Terminated,9872,9918,46,100,0.5404705821447979
12743,15,2237,10,Terminated,36070,36103,33,100,0.5404705821447979
12742,13,2237,10,Terminated,36070,36101,31,100,0.5404705821447979
12969,11,2267,12,Terminated,26016,26040,24,100,0.5404705821447979
12970,51,2267,12,Terminated,26016,26049,33,100,0.5404705821447979
12965,51,2267,12,Terminated,26016,26039,23,100,0.5404705821447979
15102,36,2548,10,Terminated,16697,16892,195,100,1.07058732171977
16072,11,2662,8,Terminated,25120,25154,34,100,0.5404705821447979
16188,11,2677,3,Terminated,26920,26964,44,100,0.5404705821447979
16913,15,2763,10,Terminated,33375,33399,24,100,0.5404705821447979
16912,15,2763,10,Terminated,33375,33398,23,100,0.5404705821447979
16908,15,2763,10,Terminated,33375,33398,23,100,0.5404705821447979
18264,13,2934,8,Terminated,44956,45005,49,100,0.5404705821447979
18265,15,2934,8,Terminated,44956,45012,56,100,0.5404705821447979
18430,95,2952,3,Terminated,46026,46047,21,100,0.5404705821447979
18432,39,2952,3,Terminated,46026,46046,20,100,0.5404705821447979
18435,55,2952,3,Terminated,46026,46046,20,100,0.5404705821447979
19020,23,3020,3,Terminated,51375,51395,20,100,0.5404705821447979
19025,23,3020,3,Terminated,51375,51395,20,100,0.5404705821447979
19026,23,3020,3,Terminated,51375,51395,20,100,0.5404705821447979
19043,11,3023,10,Terminated,51417,51461,44,100,0.5404705821447979
19044,15,3023,10,Terminated,51417,51468,51,100,0.5404705821447979
19045,17,3023,10,Terminated,51417,51476,59,100,0.5404705821447979
19128,17,3030,12,Terminated,52113,52159,46,100,0.5404705821447979
19129,19,3030,12,Terminated,52113,52166,53,100,0.5404705821447979
19127,13,3030,12,Terminated,52113,52152,39,100,0.5404705821447979
19126,11,3030,12,Terminated,52113,52144,31,100,0.5404705821447979
19447,11,3066,12,Terminated,54833,54871,38,100,0.5404705821447979
19448,13,3066,12,Terminated,54833,54877,44,100,0.5404705821447979
19464,13,3068,10,Terminated,54847,54885,38,100,0.5404705821447979
19465,17,3068,10,Terminated,54847,54891,44,100,0.5404705821447979
19466,19,3068,10,Terminated,54847,54897,50,100,0.5404705821447979
19463,11,3068,10,Terminated,54847,54879,32,100,0.5404705821447979
19827,23,3108,8,Terminated,57690,57711,21,100,1.07058732171977
20120,55,3155,10,Terminated,59480,59502,22,100,1.07058732171977
20370,55,3223,10,Terminated,24019,24129,110,100,0.5404705821447979
20834,29,3346,10,Terminated,27257,27432,175,100,0.275412212357311
21238,10,3466,8,Terminated,1370,1402,32,100,0.5404705821447979
21747,11,3580,3,Terminated,21301,21434,133,100,0.275412212357311
21810,98,3595,3,Terminated,23523,23584,61,100,0.275412212357311
22147,53,3679,12,Terminated,39933,39994,61,100,0.5404705821447979
22150,13,3679,12,Terminated,39933,39976,43,100,0.5404705821447979
22146,14,3679,12,Terminated,39933,39990,57,100,0.5404705821447979
22340,11,3721,3,Terminated,46393,46497,104,100,0.275412212357311
31358,15,5015,10,Terminated,1146,1210,64,100,0.5404705821447979
31357,39,5015,10,Terminated,1146,1209,63,100,0.5404705821447979
31376,15,5017,12,Terminated,1313,1344,31,100,0.5404705821447979
31371,77,5017,12,Terminated,1313,1345,32,100,0.5736028783682341
31372,15,5017,12,Terminated,1313,1341,28,100,0.5736028783682341
31379,35,5018,3,Terminated,1663,1700,37,100,0.5404705821447979
31772,84,5069,12,Terminated,20627,20738,111,100,0.5404705821447979
31774,29,5069,12,Terminated,20627,20768,141,100,0.5404705821447979
31770,85,5069,12,Terminated,20627,20796,169,100,0.5404705821447979
31791,13,5072,3,Terminated,20882,20998,116,100,0.5404705821447979
31795,11,5072,3,Terminated,20882,20948,66,100,0.5404705821447979
32168,62,5130,12,Terminated,9258,9313,55,100,0.5404705821447979
32169,63,5130,12,Terminated,9258,9319,61,100,0.5404705821447979
32210,63,5137,10,Terminated,21892,21942,50,100,0.5404705821447979
32211,63,5137,10,Terminated,21892,21951,59,100,0.5404705821447979
32240,51,5142,8,Terminated,38073,38122,49,100,0.5404705821447979
32241,51,5142,8,Terminated,38073,38130,57,100,0.5404705821447979
32269,18,5152,3,Terminated,34894,35069,175,100,0.275412212357311
32313,69,5165,3,Terminated,4844,4908,64,75,1.8657624310822298
32319,69,5167,12,Terminated,4846,4913,67,75,1.8657624310822298
32322,45,5168,10,Terminated,4857,4917,60,75,1.6007040612947399
32353,21,5178,3,Terminated,5778,5875,97,75,1.33564569150726
32368,21,5183,12,Terminated,5785,5888,103,75,1.33564569150726
32385,21,5188,12,Terminated,5896,5966,70,75,1.33564569150726
32420,12,5200,10,Terminated,21920,21990,70,75,1.6007040612947399
32466,46,5215,8,Terminated,38424,38480,56,75,1.07058732171977
32502,90,5220,8,Terminated,2397,2446,49,100,1.07058732171977
32510,39,5223,10,Terminated,2529,2579,50,100,1.07058732171977
32508,43,5223,10,Terminated,2529,2687,158,100,1.07058732171977
32529,98,5232,8,Terminated,3253,3295,42,100,0.275412212357311
32535,53,5234,12,Terminated,2619,2693,74,100,1.07058732171977
32533,83,5234,12,Terminated,2619,2762,143,100,1.07058732171977
32534,29,5234,12,Terminated,2619,2714,95,100,1.07058732171977
33882,61,5530,3,Terminated,29014,29175,161,100,0.5404705821447979
33883,61,5530,3,Terminated,29014,29203,189,100,0.5404705821447979
36128,39,5896,10,Terminated,22721,22751,30,100,0.5404705821447979
36135,89,5896,10,Terminated,22721,22752,31,100,0.5404705821447979
36129,89,5896,10,Terminated,22721,22751,30,100,0.5404705821447979
36127,97,5896,10,Terminated,22721,22755,34,100,0.5404705821447979
36131,34,5896,10,Terminated,22721,22745,24,100,0.5404705821447979
36791,10,6068,10,Terminated,35884,35990,106,100,0.275412212357311
37531,91,6224,10,Terminated,41352,41385,33,100,0.5404705821447979
37536,46,6224,10,Terminated,41351,41384,33,100,0.5404705821447979
37931,83,6281,3,Terminated,25609,25802,193,100,0.5404705821447979
37933,74,6281,3,Terminated,25609,25786,177,100,0.5404705821447979
40216,11,6774,12,Terminated,54089,54165,76,100,0.5404705821447979
60633,97,9355,8,Terminated,2825,2917,92,100,0.5404705821447979
60905,80,9410,12,Terminated,2718,2888,170,100,0.5404705821447979
61334,83,9500,8,Terminated,5250,5316,66,100,0.5404705821447979
61337,11,9500,8,Terminated,5250,5304,54,100,0.5404705821447979
61336,38,9500,8,Terminated,5250,5272,22,100,0.5404705821447979
61335,32,9500,8,Terminated,5250,5296,46,100,0.5404705821447979
61333,71,9500,8,Terminated,5250,5302,52,100,0.5404705821447979
61478,22,9530,12,Terminated,2133,2160,27,100,0.5404705821447979
62064,61,9582,3,Terminated,7273,7293,20,100,0.5404705821447979
62112,37,9587,12,Terminated,7456,7527,71,100,0.5404705821447979
62113,45,9587,12,Terminated,7456,7528,72,100,0.5404705821447979
62117,49,9587,12,Terminated,7456,7528,72,100,0.5404705821447979
62122,45,9587,12,Terminated,7456,7528,72,100,0.5404705821447979
62669,41,9616,10,Terminated,9218,9266,48,100,0.5404705821447979
62674,41,9616,10,Terminated,9218,9266,48,100,0.5404705821447979
62668,37,9616,10,Terminated,9218,9247,29,100,0.5404705821447979
62691,49,9619,8,Terminated,9285,9332,47,100,0.5404705821447979
62692,31,9619,8,Terminated,9285,9312,27,100,0.5404705821447979
62695,11,9619,8,Terminated,9285,9330,45,100,0.5404705821447979
62696,49,9619,8,Terminated,9285,9332,47,100,0.5404705821447979
63058,99,9691,8,Terminated,37922,37977,55,100,0.5404705821447979
63386,96,9747,8,Terminated,2930,3055,125,100,0.5404705821447979
63442,49,9763,12,Terminated,19531,19589,58,100,0.5404705821447979
63445,19,9763,12,Terminated,19531,19557,26,100,0.5404705821447979
63443,28,9763,12,Terminated,19531,19574,43,100,0.5404705821447979
63446,49,9763,12,Terminated,19531,19601,70,100,1.6007040612947399
64236,34,10258,12,Terminated,41599,41678,79,100,0.275412212357311
64663,90,10346,12,Terminated,18155,18342,187,60,0.5736028783682341
64666,39,10347,12,Terminated,19761,19885,124,75,1.6007040612947399
64727,64,10375,12,Terminated,43238,43376,138,70,1.33564569150726
64729,72,10376,3,Terminated,43239,43327,88,75,1.33564569150726
64745,64,10384,3,Terminated,50453,50568,115,70,1.33564569150726
64751,72,10387,12,Terminated,50511,50684,173,75,1.33564569150726
64900,15,10424,12,Terminated,55047,55079,32,100,0.5404705821447979
64902,13,10424,12,Terminated,55047,55072,25,100,0.5404705821447979
64903,15,10424,12,Terminated,55047,55086,39,100,0.5404705821447979
64905,21,10426,8,Terminated,55148,55169,21,100,0.5404705821447979
64908,21,10426,8,Terminated,55148,55177,29,100,0.5404705821447979
64935,15,10438,8,Terminated,55664,55698,34,100,0.5404705821447979
64937,13,10438,8,Terminated,55664,55691,27,100,0.5404705821447979
64938,15,10438,8,Terminated,55664,55705,41,100,0.5404705821447979
64957,15,10446,10,Terminated,56428,56459,31,100,0.5404705821447979
64958,17,10446,10,Terminated,56428,56473,45,100,0.5404705821447979
64955,17,10446,10,Terminated,56428,56466,38,100,0.5404705821447979
64990,13,10460,8,Terminated,57017,57037,20,100,0.5404705821447979
64993,13,10460,8,Terminated,57017,57043,26,100,0.5404705821447979
65100,13,10503,8,Terminated,59118,59142,24,100,0.5404705821447979
65103,13,10503,8,Terminated,59118,59148,30,100,0.5404705821447979
65118,13,10509,12,Terminated,59364,59394,30,100,0.5404705821447979
65115,13,10509,12,Terminated,59364,59387,23,100,0.5404705821447979
65657,11,10614,10,Terminated,2579,2779,200,75,1.6007040612947399
65792,71,10623,12,Terminated,14191,14290,99,75,1.6007040612947399
65909,31,10632,10,Terminated,33057,33089,32,40,1.6007040612947399
65922,31,10634,3,Terminated,50797,50824,27,40,1.6007040612947399
65923,31,10634,3,Terminated,50797,50830,33,40,1.6007040612947399
66067,21,10677,8,Terminated,37185,37348,163,100,0.5404705821447979
66061,21,10677,8,Terminated,37185,37295,110,100,0.5404705821447979
66679,93,10816,12,Terminated,42139,42220,81,100,0.5736028783682341
66677,95,10816,12,Terminated,42139,42253,114,100,0.5736028783682341
68148,12,11125,10,Terminated,46494,46628,134,100,0.275412212357311
69923,11,11465,12,Terminated,35591,35660,69,100,0.5404705821447979
69921,43,11465,12,Terminated,35591,35682,91,100,0.5404705821447979
69922,32,11465,12,Terminated,35591,35659,68,100,0.5404705821447979
70390,35,11552,10,Terminated,47580,47757,177,100,0.275412212357311
70750,21,11642,12,Terminated,49837,49859,22,100,0.5404705821447979
70753,23,11644,8,Terminated,49838,49864,26,100,0.5404705821447979
70965,27,11678,10,Terminated,51711,51841,130,100,0.5404705821447979
71178,74,11717,3,Terminated,23549,23664,115,100,1.6007040612947399
71213,93,11736,3,Terminated,36643,36668,25,100,0.5404705821447979
71210,97,11736,3,Terminated,36643,36699,56,100,0.5404705821447979
71251,55,11749,8,Terminated,52561,52622,61,100,0.5404705821447979
71406,10,11768,10,Terminated,1161,1197,36,100,0.5404705821447979
71403,61,11768,10,Terminated,1161,1197,36,100,0.5404705821447979
71398,97,11768,10,Terminated,1161,1199,38,100,0.5404705821447979
71588,10,11777,3,Terminated,9992,10037,45,100,0.5404705821447979
71585,81,11777,3,Terminated,9992,10036,44,100,0.5404705821447979
71580,73,11777,3,Terminated,9992,10040,48,100,0.5404705821447979
71602,73,11778,12,Terminated,10922,10961,39,100,0.5404705821447979
71610,10,11778,12,Terminated,10922,10959,37,100,0.5404705821447979
71607,81,11778,12,Terminated,10922,10961,39,100,0.5404705821447979
72111,33,11812,10,Terminated,46000,46038,38,100,0.5404705821447979
72115,10,11812,10,Terminated,46000,46034,34,100,0.5404705821447979
72114,25,11812,10,Terminated,46000,46035,35,100,0.5404705821447979
72278,25,11818,8,Terminated,54105,54143,38,100,0.5404705821447979
72275,33,11818,8,Terminated,54105,54144,39,100,0.5404705821447979
72279,10,11818,8,Terminated,54105,54141,36,100,0.5404705821447979
72384,33,11823,12,Terminated,59495,59529,34,100,0.5404705821447979
72388,10,11823,12,Terminated,59495,59526,31,100,0.5404705821447979
72387,25,11823,12,Terminated,59495,59527,32,100,0.5404705821447979
72692,47,11868,8,Terminated,22107,22303,196,100,0.5404705821447979
72887,51,11896,8,Terminated,27347,27383,36,100,0.5404705821447979
72879,55,11896,8,Terminated,27347,27419,72,100,0.5404705821447979
74278,95,12038,12,Terminated,19755,19807,52,100,0.5404705821447979
74294,83,12038,12,Terminated,19755,19806,51,100,0.5404705821447979
74290,12,12038,12,Terminated,19755,19796,41,100,1.6007040612947399
74277,15,12038,12,Terminated,19755,19796,41,100,0.5404705821447979
74281,33,12038,12,Terminated,19755,19797,42,100,1.6007040612947399
74289,83,12038,12,Terminated,19755,19806,51,100,1.6007040612947399
74405,11,12051,10,Terminated,51427,51475,48,100,1.6007040612947399
74406,15,12051,10,Terminated,51427,51483,56,100,1.6007040612947399
74403,31,12051,10,Terminated,51427,51556,129,100,0.5404705821447979
74404,43,12051,10,Terminated,51427,51557,130,100,0.5404705821447979
74402,15,12051,10,Terminated,51427,51556,129,100,1.6007040612947399
74790,11,12100,8,Terminated,16527,16568,41,100,0.5404705821447979
74787,14,12100,8,Terminated,16527,16640,113,100,0.5404705821447979
76942,11,12508,8,Terminated,25879,25930,51,100,0.275412212357311
77792,11,12575,10,Terminated,40162,40215,53,100,0.275412212357311
77799,11,12577,8,Terminated,40247,40296,49,100,0.275412212357311
80345,72,12916,12,Terminated,3707,3858,151,100,0.5736028783682341
36,19,10,8,Terminated,8077,8260,183,100,0.5404705821447979
32,17,10,8,Terminated,8077,8260,183,100,0.5404705821447979
31,27,10,8,Terminated,8077,8263,186,100,0.5404705821447979
30,19,10,8,Terminated,8077,8260,183,100,0.5404705821447979
29,15,10,8,Terminated,8077,8260,183,100,0.5404705821447979
657,53,112,10,Terminated,52203,52256,53,100,0.5404705821447979
650,17,112,10,Terminated,52203,52365,162,100,0.5404705821447979
709,45,126,10,Terminated,899,991,92,100,0.5404705821447979
711,45,126,10,Terminated,899,992,93,100,0.5404705821447979
710,45,126,10,Terminated,899,991,92,100,0.5404705821447979
1774,19,345,8,Terminated,14216,14355,139,60,1.33564569150726
1830,23,359,3,Terminated,29399,29493,94,55,1.6007040612947399
1905,37,370,8,Terminated,42829,42916,87,100,0.5404705821447979
1906,17,370,8,Terminated,42829,42933,104,100,0.5404705821447979
1903,27,370,8,Terminated,42829,42957,128,100,0.5404705821447979
3119,51,583,3,Terminated,16128,16211,83,100,0.5404705821447979
3133,51,587,8,Terminated,18191,18230,39,100,0.5404705821447979
3149,51,592,3,Terminated,22229,22264,35,100,0.5404705821447979
3233,51,616,8,Terminated,32621,32662,41,100,0.5404705821447979
3418,51,670,10,Terminated,54951,54998,47,100,0.5404705821447979
3447,51,679,10,Terminated,58026,58055,29,100,0.5404705821447979
5171,10,995,3,Terminated,20148,20209,61,100,0.275412212357311
5400,60,997,8,Terminated,1172,1292,120,100,0.5404705821447979
5428,75,997,8,Terminated,1172,1299,127,100,0.5404705821447979
7417,33,1270,8,Terminated,27689,27835,146,100,0.5404705821447979
7418,33,1270,8,Terminated,27689,27881,192,100,0.5404705821447979
8395,18,1468,12,Terminated,14242,14367,125,100,0.5404705821447979
8396,94,1468,12,Terminated,14242,14375,133,100,0.5404705821447979
8628,77,1542,12,Terminated,39144,39260,116,100,0.5404705821447979
10111,13,1842,12,Terminated,14242,14268,26,100,0.5404705821447979
10114,73,1842,12,Terminated,14242,14295,53,100,0.5404705821447979
10109,24,1842,12,Terminated,14242,14275,33,100,0.5404705821447979
10117,73,1842,12,Terminated,14242,14301,59,100,0.5404705821447979
10328,11,1871,8,Terminated,26041,26084,43,100,0.5404705821447979
10329,23,1871,8,Terminated,26041,26087,46,100,0.5404705821447979
10393,21,1880,12,Terminated,40352,40531,179,100,0.5404705821447979
10399,16,1880,12,Terminated,40352,40418,66,100,0.5404705821447979
10510,29,1895,8,Terminated,51371,51414,43,100,0.5404705821447979
10509,19,1895,8,Terminated,51371,51411,40,100,0.5404705821447979
10506,41,1895,8,Terminated,51371,51415,44,100,0.5404705821447979
11096,18,1966,10,Terminated,6255,6283,28,40,0.7832681904071641
11138,11,1972,8,Terminated,29777,29868,91,100,0.5404705821447979
11190,18,1983,3,Terminated,55144,55206,62,55,1.33564569150726
11375,14,2015,3,Terminated,9943,9968,25,100,0.5404705821447979
11569,50,2040,8,Terminated,30741,30789,48,100,0.5404705821447979
11563,51,2040,8,Terminated,30741,30798,57,100,0.5404705821447979
11633,13,2054,12,Terminated,6358,6436,78,100,0.5404705821447979
11634,15,2054,12,Terminated,6358,6436,78,100,0.5404705821447979
11737,13,2080,10,Terminated,32495,32645,150,100,0.5404705821447979
11738,15,2080,10,Terminated,32495,32646,151,100,0.5404705821447979
11810,45,2098,8,Terminated,48668,48759,91,100,0.5404705821447979
11809,43,2098,8,Terminated,48668,48758,90,100,0.5404705821447979
11814,55,2099,3,Terminated,49570,49659,89,100,0.5404705821447979
11813,53,2099,3,Terminated,49570,49656,86,100,0.5404705821447979
11817,31,2100,10,Terminated,50606,50696,90,100,0.5404705821447979
11818,33,2100,10,Terminated,50606,50696,90,100,0.5404705821447979
11834,29,2104,12,Terminated,54082,54182,100,100,0.5404705821447979
11833,27,2104,12,Terminated,54082,54181,99,100,0.5404705821447979
12159,11,2167,3,Terminated,46583,46775,192,100,0.5404705821447979
12776,13,2239,3,Terminated,43271,43298,27,100,0.5404705821447979
12777,15,2239,3,Terminated,43271,43300,29,100,0.5404705821447979
14990,11,2535,12,Terminated,16125,16166,41,100,0.5404705821447979
15106,36,2549,10,Terminated,16981,17060,79,100,1.07058732171977
15107,48,2549,10,Terminated,16981,17156,175,100,1.07058732171977
15135,11,2558,3,Terminated,17070,17102,32,100,0.5404705821447979
15874,11,2638,3,Terminated,23309,23341,32,100,0.5404705821447979
17516,13,2841,10,Terminated,38602,38658,56,100,0.5404705821447979
17515,11,2841,10,Terminated,38602,38650,48,100,0.5404705821447979
17912,15,2885,3,Terminated,42235,42289,54,100,0.5404705821447979
17911,13,2885,3,Terminated,42235,42283,48,100,0.5404705821447979
18107,63,2910,10,Terminated,43332,43366,34,100,1.07058732171977
18511,11,2961,3,Terminated,46916,46963,47,100,0.5404705821447979
18673,11,2980,3,Terminated,48511,48597,86,100,0.5404705821447979
18674,15,2980,3,Terminated,48511,48608,97,100,0.5404705821447979
18675,17,2980,3,Terminated,48511,48617,106,100,0.5404705821447979
18857,11,3000,8,Terminated,50313,50361,48,100,0.5404705821447979
19028,11,3021,12,Terminated,51412,51459,47,100,0.5404705821447979
19150,13,3032,8,Terminated,52107,52160,53,100,0.5404705821447979
19149,11,3032,8,Terminated,52107,52155,48,100,0.5404705821447979
19810,43,3106,12,Terminated,57683,57708,25,100,0.5404705821447979
19809,43,3106,12,Terminated,57683,57707,24,100,0.5404705821447979
19831,85,3109,3,Terminated,57780,57874,94,100,1.07058732171977
19830,66,3109,3,Terminated,57780,57928,148,100,1.07058732171977
19964,90,3134,8,Terminated,58868,59045,177,100,0.275412212357311
20081,11,3149,3,Terminated,59336,59391,55,100,0.5404705821447979
20067,13,3149,3,Terminated,59336,59397,61,100,0.5404705821447979
20068,15,3149,3,Terminated,59336,59404,68,100,0.5404705821447979
20080,10,3149,3,Terminated,59336,59385,49,100,0.5404705821447979
20201,86,3171,3,Terminated,2322,2344,22,100,0.5404705821447979
20202,86,3171,3,Terminated,2322,2345,23,100,0.5404705821447979
20215,86,3173,10,Terminated,2399,2426,27,100,0.5404705821447979
20216,86,3173,10,Terminated,2399,2428,29,100,0.5404705821447979
20249,86,3178,3,Terminated,3404,3428,24,100,0.5404705821447979
20248,86,3178,3,Terminated,3404,3425,21,100,0.5404705821447979
21670,52,3568,3,Terminated,19311,19485,174,100,0.275412212357311
22531,13,3768,3,Terminated,54939,54974,35,100,0.5404705821447979
22528,53,3768,3,Terminated,54939,54973,34,100,0.5404705821447979
22527,14,3768,3,Terminated,54939,54988,49,100,0.5404705821447979
31240,63,5005,10,Terminated,3019,3097,78,100,0.5404705821447979
31241,71,5005,10,Terminated,3019,3103,84,100,0.5404705821447979
31245,63,5005,10,Terminated,3019,3101,82,100,0.5404705821447979
31456,81,5029,3,Terminated,3156,3195,39,100,0.5404705821447979
31455,27,5029,3,Terminated,3156,3195,39,100,0.5404705821447979
31454,80,5029,3,Terminated,3156,3194,38,100,0.5736028783682341
31458,15,5030,12,Terminated,3375,3489,114,100,0.5404705821447979
31457,11,5030,12,Terminated,3375,3475,100,100,0.5404705821447979
31459,11,5030,12,Terminated,3375,3468,93,100,0.5404705821447979
32157,63,5128,8,Terminated,5677,5736,59,100,0.5404705821447979
32156,62,5128,8,Terminated,5677,5729,52,100,0.5404705821447979
32180,62,5132,12,Terminated,12854,12899,45,100,0.5404705821447979
32181,63,5132,12,Terminated,12854,12905,51,100,0.5404705821447979
32192,62,5134,12,Terminated,16453,16502,49,100,0.5404705821447979
32193,63,5134,12,Terminated,16453,16510,57,100,0.5404705821447979
32228,63,5140,8,Terminated,27251,27308,57,100,0.5404705821447979
32229,63,5140,8,Terminated,27251,27316,65,100,0.5404705821447979
32304,69,5162,12,Terminated,4836,4907,71,75,1.8657624310822298
32307,69,5163,10,Terminated,4837,4902,65,75,1.8657624310822298
32377,29,5186,12,Terminated,5820,5888,68,75,1.33564569150726
32396,89,5192,3,Terminated,10993,11105,112,75,1.33564569150726
32441,50,5207,8,Terminated,25245,25309,64,75,1.33564569150726
32858,25,5345,3,Terminated,29650,29691,41,100,0.5404705821447979
32853,29,5345,3,Terminated,29650,29692,42,100,0.5404705821447979
32859,37,5345,3,Terminated,29650,29702,52,100,0.5404705821447979
33957,23,5546,8,Terminated,51849,51931,82,100,0.275412212357311
34466,15,5652,12,Terminated,3649,3720,71,100,0.5404705821447979
34467,17,5652,12,Terminated,3649,3844,195,100,0.5404705821447979
34979,41,5711,3,Terminated,13378,13507,129,100,0.5404705821447979
34981,41,5711,3,Terminated,13378,13486,108,100,0.5404705821447979
34975,40,5711,3,Terminated,13378,13480,102,100,0.5404705821447979
34980,41,5711,3,Terminated,13378,13486,108,100,0.5404705821447979
35068,57,5723,3,Terminated,15546,15574,28,100,0.5404705821447979
35067,19,5723,3,Terminated,15546,15575,29,100,0.5404705821447979
35065,56,5723,3,Terminated,15546,15574,28,100,0.5404705821447979
35069,79,5723,3,Terminated,15546,15576,30,100,0.5404705821447979
35064,79,5723,3,Terminated,15546,15575,29,100,0.5404705821447979
35063,59,5723,3,Terminated,15546,15574,28,100,0.5404705821447979
36396,31,5969,8,Terminated,29171,29299,128,100,0.275412212357311
36666,61,6032,12,Terminated,26766,26844,78,100,0.5404705821447979
36669,20,6032,12,Terminated,26766,26807,41,100,0.5404705821447979
36667,25,6032,12,Terminated,26766,26808,42,100,0.5404705821447979
36668,15,6032,12,Terminated,26766,26813,47,100,0.5404705821447979
36797,45,6069,8,Terminated,35710,35795,85,100,0.5404705821447979
36792,47,6069,8,Terminated,35710,35820,110,100,0.5404705821447979
36844,22,6075,10,Terminated,38375,38408,33,100,0.275412212357311
37023,74,6115,3,Terminated,53318,53430,112,100,0.275412212357311
37024,12,6115,3,Terminated,53318,53350,32,100,0.275412212357311
37032,25,6116,12,Terminated,53550,53572,22,100,0.5404705821447979
37030,25,6116,12,Terminated,53550,53572,22,100,0.5404705821447979
37026,25,6116,12,Terminated,53550,53571,21,100,0.5404705821447979
37031,25,6116,12,Terminated,53550,53571,21,100,0.5404705821447979
37029,25,6116,12,Terminated,53550,53572,22,100,0.5404705821447979
37257,55,6179,10,Terminated,6003,6052,49,100,0.5404705821447979
37256,54,6179,10,Terminated,6003,6046,43,100,0.5404705821447979
37258,55,6179,10,Terminated,6003,6054,51,100,0.5404705821447979
37397,67,6199,3,Terminated,27582,27642,60,100,0.5404705821447979
37398,67,6199,3,Terminated,27582,27640,58,100,0.5404705821447979
37396,67,6199,3,Terminated,27582,27632,50,100,0.5404705821447979
37427,76,6204,10,Terminated,35575,35621,46,100,0.5404705821447979
37428,77,6204,10,Terminated,35575,35629,54,100,0.5404705821447979
37429,77,6204,10,Terminated,35575,35629,54,100,0.5404705821447979
37626,15,6236,8,Terminated,47678,47852,174,100,0.275412212357311
39223,11,6538,8,Terminated,42333,42413,80,100,0.5404705821447979
40690,100,6877,10,Terminated,3264,3286,22,100,0.5404705821447979
40698,100,6879,3,Terminated,3358,3400,42,100,0.5404705821447979
59865,87,9085,3,Terminated,24124,24170,46,75,1.33564569150726
60143,13,9109,12,Terminated,32440,32480,40,100,0.5404705821447979
60142,35,9109,12,Terminated,32440,32475,35,100,0.5404705821447979
60144,13,9109,12,Terminated,32440,32476,36,100,0.5404705821447979
60147,15,9110,10,Terminated,36057,36104,47,100,0.5404705821447979
60146,15,9110,10,Terminated,36057,36117,60,100,0.5404705821447979
60145,40,9110,10,Terminated,36057,36102,45,100,0.5404705821447979
60156,19,9113,3,Terminated,43230,43292,62,100,0.5404705821447979
60159,17,9113,3,Terminated,43230,43290,60,100,0.5404705821447979
60157,48,9113,3,Terminated,43230,43284,54,100,0.5404705821447979
60808,87,9390,12,Terminated,10060,10174,114,100,0.5404705821447979
60807,87,9390,12,Terminated,10060,10145,85,100,0.5404705821447979
60831,10,9396,12,Terminated,17812,17933,121,100,0.275412212357311
61253,71,9489,10,Terminated,2370,2409,39,100,0.5404705821447979
61256,38,9489,10,Terminated,2370,2390,20,100,0.5404705821447979
61257,11,9489,10,Terminated,2370,2422,52,100,0.5404705821447979
61255,32,9489,10,Terminated,2370,2403,33,100,0.5404705821447979
61254,83,9489,10,Terminated,2370,2432,62,100,0.5404705821447979
61413,11,9514,3,Terminated,19603,19660,57,100,0.5404705821447979
61410,83,9514,3,Terminated,19603,19668,65,100,0.5404705821447979
61411,32,9514,3,Terminated,19603,19653,50,100,0.5404705821447979
61409,71,9514,3,Terminated,19603,19659,56,100,0.5404705821447979
61549,21,9542,10,Terminated,2478,2531,53,100,1.6007040612947399
61594,89,9549,8,Terminated,2779,2806,27,100,0.5404705821447979
62649,43,9613,3,Terminated,8908,8990,82,100,0.5404705821447979
62953,10,9648,12,Terminated,6396,6574,178,100,0.275412212357311
63405,67,9754,10,Terminated,10922,10984,62,100,0.5404705821447979
63401,77,9754,10,Terminated,10922,11102,180,100,0.5404705821447979
63404,67,9754,10,Terminated,10922,10974,52,100,0.5404705821447979
64114,10,10222,12,Terminated,15191,15253,62,100,0.5404705821447979
64112,85,10222,12,Terminated,15191,15231,40,100,0.5404705821447979
64113,95,10222,12,Terminated,15191,15346,155,100,0.5404705821447979
64256,53,10262,3,Terminated,787,926,139,100,0.5404705821447979
64791,75,10402,8,Terminated,22181,22261,80,55,1.6007040612947399
64890,15,10420,12,Terminated,54873,54902,29,100,0.5404705821447979
64892,13,10420,12,Terminated,54873,54897,24,100,0.5404705821447979
64893,15,10420,12,Terminated,54873,54908,35,100,0.5404705821447979
64950,17,10444,3,Terminated,55952,55994,42,100,0.5404705821447979
64952,15,10444,3,Terminated,55952,55987,35,100,0.5404705821447979
64953,17,10444,3,Terminated,55952,55999,47,100,0.5404705821447979
65083,13,10495,8,Terminated,58799,58827,28,100,0.5404705821447979
65080,13,10495,8,Terminated,58799,58820,21,100,0.5404705821447979
65090,13,10499,12,Terminated,58955,58976,21,100,0.5404705821447979
65093,13,10499,12,Terminated,58955,58984,29,100,0.5404705821447979
65640,23,10611,12,Terminated,31164,31263,99,100,0.5404705821447979
65633,25,10611,12,Terminated,31164,31262,98,100,0.5404705821447979
65638,25,10611,12,Terminated,31164,31263,99,100,0.5404705821447979
65632,23,10611,12,Terminated,31164,31262,98,100,0.5404705821447979
69502,16,11379,12,Terminated,23333,23459,126,100,0.5404705821447979
69506,23,11379,12,Terminated,23333,23454,121,100,0.5404705821447979
69504,23,11379,12,Terminated,23333,23466,133,100,0.5404705821447979
69505,23,11379,12,Terminated,23333,23461,128,100,0.5404705821447979
69503,23,11379,12,Terminated,23333,23461,128,100,0.5404705821447979
70718,26,11634,3,Terminated,49956,50143,187,100,0.275412212357311
70729,30,11637,3,Terminated,49982,50155,173,100,0.275412212357311
71199,88,11732,10,Terminated,34904,34926,22,100,0.5404705821447979
71200,89,11732,10,Terminated,34904,34931,27,100,0.5404705821447979
71197,93,11732,10,Terminated,34904,34996,92,100,0.5404705821447979
71300,85,11759,8,Terminated,1657,1688,31,100,0.5404705821447979
71421,97,11769,3,Terminated,1967,2009,42,100,0.5404705821447979
71426,61,11769,3,Terminated,1967,2001,34,100,0.5404705821447979
71429,10,11769,3,Terminated,1967,2002,35,100,0.5404705821447979
71475,10,11771,3,Terminated,3737,3774,37,100,0.5404705821447979
71472,61,11771,3,Terminated,3737,3773,36,100,0.5404705821447979
71467,97,11771,3,Terminated,3737,3776,39,100,0.5404705821447979
72306,10,11819,8,Terminated,54995,55031,36,100,0.5404705821447979
72305,25,11819,8,Terminated,54995,55035,40,100,0.5404705821447979
72302,33,11819,8,Terminated,54995,55039,44,100,0.5404705821447979
73184,29,11926,8,Terminated,37787,37861,74,100,0.5404705821447979
73191,14,11926,8,Terminated,37787,37829,42,100,0.5404705821447979
73185,31,11926,8,Terminated,37787,37862,75,100,0.5404705821447979
73197,15,11926,8,Terminated,37787,37850,63,100,0.5404705821447979
73195,29,11926,8,Terminated,37787,37861,74,100,0.5404705821447979
73441,19,11957,12,Terminated,58499,58569,70,100,0.5404705821447979
73445,89,11957,12,Terminated,58499,58527,28,100,0.5736028783682341
73676,73,11984,8,Terminated,19805,19863,58,100,0.5404705821447979
73674,13,11984,8,Terminated,19805,19845,40,100,0.5404705821447979
73680,13,11984,8,Terminated,19805,19835,30,100,0.5404705821447979
73673,13,11984,8,Terminated,19805,19843,38,100,0.5404705821447979
74621,37,12074,3,Terminated,4332,4397,65,100,0.5404705821447979
74623,35,12074,3,Terminated,4332,4390,58,100,0.5404705821447979
74624,37,12074,3,Terminated,4332,4399,67,100,0.5404705821447979
74625,37,12074,3,Terminated,4332,4400,68,100,0.5404705821447979
74744,23,12094,3,Terminated,14879,15045,166,100,0.5404705821447979
74747,21,12094,3,Terminated,14879,14950,71,100,0.5404705821447979
74750,21,12094,3,Terminated,14879,15010,131,100,0.5404705821447979
74745,25,12094,3,Terminated,14879,15046,167,100,0.5736028783682341
74752,25,12094,3,Terminated,14879,15046,167,100,0.5736028783682341
74916,88,12111,10,Terminated,18020,18055,35,100,0.5404705821447979
74963,46,12117,10,Terminated,18217,18329,112,100,0.5404705821447979
78802,11,12661,10,Terminated,54530,54552,22,100,0.275412212357311
79130,11,12686,12,Terminated,57877,57904,27,100,0.5404705821447979
80412,37,12929,10,Terminated,15826,15893,67,100,0.5404705821447979
606,21,105,10,Terminated,52297,52493,196,100,0.275412212357311
1279,50,217,12,Terminated,32523,32547,24,100,0.5404705821447979
1952,15,375,8,Terminated,51754,51887,133,100,0.5404705821447979
1950,13,375,8,Terminated,51755,51806,51,100,0.5404705821447979
1948,43,375,8,Terminated,51754,51873,119,100,0.5404705821447979
1954,13,375,8,Terminated,51755,51813,58,100,0.5404705821447979
1951,29,375,8,Terminated,51754,51938,184,100,0.5404705821447979
2640,26,512,12,Terminated,30763,30917,154,55,0.9271866021277142
3163,51,596,3,Terminated,24011,24054,43,100,0.5404705821447979
3326,51,641,12,Terminated,43430,43464,34,100,0.5404705821447979
3342,51,646,10,Terminated,45473,45522,49,100,0.5404705821447979
5149,18,991,10,Terminated,18824,18845,21,100,0.5404705821447979
5712,25,1025,3,Terminated,16173,16314,141,100,0.5404705821447979
5713,25,1025,3,Terminated,16173,16353,180,100,0.5404705821447979
5711,70,1025,3,Terminated,16173,16262,89,100,0.5404705821447979
8555,11,1513,3,Terminated,35817,35971,154,100,0.275412212357311
9917,24,1812,8,Terminated,22869,22917,48,100,0.275412212357311
10016,11,1827,8,Terminated,5480,5542,62,100,0.5404705821447979
10017,23,1827,8,Terminated,5480,5544,64,100,0.5404705821447979
10221,11,1858,8,Terminated,22797,22841,44,100,0.5404705821447979
10222,23,1858,8,Terminated,22797,22843,46,100,0.5404705821447979
11135,45,1970,8,Terminated,23410,23521,111,60,0.8024227991613381
11334,31,2009,8,Terminated,6572,6600,28,100,0.5404705821447979
11336,35,2009,8,Terminated,6572,6600,28,100,0.5404705821447979
11331,90,2009,8,Terminated,6572,6598,26,100,1.6007040612947399
11330,35,2009,8,Terminated,6572,6600,28,100,0.5404705821447979
11339,53,2010,12,Terminated,8340,8525,185,100,0.5404705821447979
11448,13,2022,12,Terminated,14212,14238,26,100,0.5404705821447979
11454,13,2023,10,Terminated,14335,14366,31,100,0.5404705821447979
11456,83,2023,10,Terminated,14335,14359,24,100,0.5404705821447979
11754,25,2084,8,Terminated,36075,36171,96,100,0.5404705821447979
11753,23,2084,8,Terminated,36075,36170,95,100,0.5404705821447979
11761,43,2086,12,Terminated,37880,37967,87,100,0.5404705821447979
11762,45,2086,12,Terminated,37880,37968,88,100,0.5404705821447979
11769,31,2088,12,Terminated,39678,39781,103,100,0.5404705821447979
11770,33,2088,12,Terminated,39678,39781,103,100,0.5404705821447979
11782,61,2091,10,Terminated,42446,42548,102,100,0.5404705821447979
11781,59,2091,10,Terminated,42446,42548,102,100,0.5404705821447979
11786,31,2092,10,Terminated,43290,43442,152,100,0.5404705821447979
11785,29,2092,10,Terminated,43290,43441,151,100,0.5404705821447979
11789,37,2093,3,Terminated,44176,44271,95,100,0.5404705821447979
11790,39,2093,3,Terminated,44176,44272,96,100,0.5404705821447979
11825,45,2102,8,Terminated,52272,52444,172,100,0.5404705821447979
11826,47,2102,8,Terminated,52272,52445,173,100,0.5404705821447979
11933,11,2139,8,Terminated,5513,5540,27,100,1.63383635751818
11939,11,2139,8,Terminated,5513,5540,27,100,0.5404705821447979
12001,25,2146,12,Terminated,5999,6035,36,100,0.5404705821447979
12014,33,2146,12,Terminated,5999,6040,41,100,0.5404705821447979
12002,33,2146,12,Terminated,5999,6039,40,100,0.5404705821447979
12007,24,2146,12,Terminated,5999,6030,31,100,0.5404705821447979
12013,25,2146,12,Terminated,5999,6037,38,100,0.5404705821447979
12000,61,2146,12,Terminated,5999,6041,42,100,0.5736028783682341
12079,73,2150,3,Terminated,20369,20512,143,100,0.5404705821447979
12077,29,2150,3,Terminated,20369,20461,92,100,0.5404705821447979
12074,73,2150,3,Terminated,20369,20509,140,100,0.5404705821447979
12073,43,2150,3,Terminated,20369,20493,124,100,0.5404705821447979
12078,29,2150,3,Terminated,20369,20475,106,100,0.5404705821447979
12793,13,2240,12,Terminated,46865,46893,28,100,0.5404705821447979
12794,15,2240,12,Terminated,46865,46899,34,100,0.5404705821447979
13337,11,2334,12,Terminated,2318,2361,43,100,0.5404705821447979
13377,11,2338,3,Terminated,2624,2652,28,100,0.5404705821447979
13503,11,2354,3,Terminated,3774,3811,37,100,0.5404705821447979
13781,11,2392,12,Terminated,6383,6415,32,100,0.5404705821447979
13907,11,2407,12,Terminated,7097,7129,32,100,0.5404705821447979
14368,11,2462,10,Terminated,10961,11003,42,100,0.5404705821447979
15269,11,2577,3,Terminated,18188,18228,40,100,0.5404705821447979
15321,11,2583,3,Terminated,19043,19080,37,100,0.5404705821447979
16089,57,2664,12,Terminated,25236,25257,21,100,0.5404705821447979
16095,57,2664,12,Terminated,25236,25261,25,100,0.5404705821447979
16514,11,2716,3,Terminated,29819,29858,39,100,0.5404705821447979
16672,11,2735,3,Terminated,31406,31445,39,100,0.5404705821447979
16984,11,2772,8,Terminated,34090,34141,51,100,0.5404705821447979
17273,93,2810,12,Terminated,36114,36148,34,100,1.07058732171977
18143,13,2920,8,Terminated,44044,44097,53,100,0.5404705821447979
18144,15,2920,8,Terminated,44044,44106,62,100,0.5404705821447979
18488,11,2959,8,Terminated,46921,46965,44,100,0.5404705821447979
18490,17,2959,8,Terminated,46921,46981,60,100,0.5404705821447979
18489,15,2959,8,Terminated,46921,46973,52,100,0.5404705821447979
18545,11,2965,10,Terminated,47628,47666,38,100,0.5404705821447979
18546,15,2965,10,Terminated,47628,47672,44,100,0.5404705821447979
18547,17,2965,10,Terminated,47628,47679,51,100,0.5404705821447979
18658,11,2978,12,Terminated,48504,48548,44,100,0.5404705821447979
18874,17,3002,3,Terminated,50322,50382,60,100,0.5404705821447979
18873,15,3002,3,Terminated,50322,50374,52,100,0.5404705821447979
18872,11,3002,3,Terminated,50322,50366,44,100,0.5404705821447979
19227,13,3041,10,Terminated,53015,53060,45,100,0.5404705821447979
19226,11,3041,10,Terminated,53015,53054,39,100,0.5404705821447979
19249,11,3043,3,Terminated,53183,53227,44,100,0.5404705821447979
19250,13,3043,3,Terminated,53183,53234,51,100,0.5404705821447979
19323,47,3051,3,Terminated,53253,53286,33,100,0.5404705821447979
19318,63,3051,3,Terminated,53253,53283,30,100,0.5404705821447979
19317,47,3051,3,Terminated,53253,53279,26,100,0.5404705821447979
19326,63,3051,3,Terminated,53253,53289,36,100,0.5404705821447979
19353,13,3056,12,Terminated,53945,53983,38,100,0.5404705821447979
19355,19,3056,12,Terminated,53945,53996,51,100,0.5404705821447979
19354,17,3056,12,Terminated,53945,53989,44,100,0.5404705821447979
19352,11,3056,12,Terminated,53945,53977,32,100,0.5404705821447979
19540,49,3076,10,Terminated,55039,55062,23,100,0.5404705821447979
19549,65,3076,10,Terminated,55039,55071,32,100,0.5404705821447979
19546,49,3076,10,Terminated,55039,55068,29,100,0.5404705821447979
19541,65,3076,10,Terminated,55039,55065,26,100,0.5404705821447979
19633,11,3088,12,Terminated,55915,55949,34,100,0.5404705821447979
19634,13,3088,12,Terminated,55915,55955,40,100,0.5404705821447979
19635,19,3088,12,Terminated,55915,55963,48,100,0.5404705821447979
19636,21,3088,12,Terminated,55915,55971,56,100,0.5404705821447979
19958,95,3131,10,Terminated,58504,58558,54,100,1.07058732171977
20173,86,3166,8,Terminated,2350,2386,36,100,0.5404705821447979
20172,86,3166,8,Terminated,2350,2386,36,100,0.5404705821447979
20364,50,3221,12,Terminated,24043,24204,161,100,0.5404705821447979
20993,19,3420,12,Terminated,14281,14472,191,100,0.275412212357311
21346,24,3489,3,Terminated,2564,2749,185,100,0.275412212357311
21420,34,3510,3,Terminated,4596,4723,127,100,0.275412212357311
31483,93,5032,3,Terminated,6027,6076,49,100,0.5404705821447979
31487,41,5032,3,Terminated,6027,6074,47,100,0.5404705821447979
31485,41,5032,3,Terminated,6027,6073,46,100,0.5736028783682341
31488,41,5032,3,Terminated,6027,6074,47,100,0.5404705821447979
31837,23,5075,8,Terminated,25787,25810,23,100,0.5404705821447979
31826,12,5075,8,Terminated,25786,25980,194,100,0.5404705821447979
32131,11,5122,10,Terminated,55036,55149,113,100,0.5404705821447979
32127,13,5122,10,Terminated,55035,55214,179,100,0.5404705821447979
32174,62,5131,8,Terminated,11091,11284,193,100,0.5404705821447979
32175,63,5131,8,Terminated,11091,11291,200,100,0.5404705821447979
32187,63,5133,3,Terminated,14696,14788,92,100,0.5404705821447979
32186,62,5133,3,Terminated,14696,14781,85,100,0.5404705821447979
32327,63,5169,8,Terminated,4924,4969,45,75,1.8657624310822298
32371,29,5184,12,Terminated,5815,5882,67,75,1.33564569150726
32432,12,5204,8,Terminated,21927,21999,72,75,1.6007040612947399
32438,12,5206,8,Terminated,21946,22022,76,75,1.6007040612947399
32453,47,5211,8,Terminated,28859,28980,121,75,1.07058732171977
32523,45,5229,10,Terminated,2573,2686,113,100,1.07058732171977
33142,48,5426,10,Terminated,7131,7299,168,100,0.275412212357311
34491,87,5655,12,Terminated,4937,4974,37,100,0.5404705821447979
34490,87,5655,12,Terminated,4937,4968,31,100,0.5404705821447979
35799,15,5826,10,Terminated,51531,51636,105,100,0.5404705821447979
35993,13,5857,10,Terminated,4256,4354,98,100,0.5404705821447979
35992,33,5857,10,Terminated,4256,4330,74,100,0.5404705821447979
37353,10,6195,8,Terminated,24513,24689,176,100,0.275412212357311
38001,33,6289,10,Terminated,33023,33065,42,100,0.5404705821447979
38003,97,6289,10,Terminated,33023,33070,47,100,0.5404705821447979
37999,97,6289,10,Terminated,33023,33059,36,100,0.5404705821447979
38000,33,6289,10,Terminated,33023,33064,41,100,0.5404705821447979
38002,97,6289,10,Terminated,33023,33070,47,100,0.5404705821447979
38287,13,6320,12,Terminated,38420,38457,37,100,0.5404705821447979
38280,13,6320,12,Terminated,38420,38448,28,100,0.5404705821447979
40331,11,6800,8,Terminated,55018,55100,82,100,0.5404705821447979
40341,11,6802,12,Terminated,55051,55135,84,100,0.5404705821447979
40470,11,6831,3,Terminated,55703,55791,88,100,0.5404705821447979
40579,67,6854,10,Terminated,-16,57,73,100,0.5404705821447979
40580,59,6854,10,Terminated,-16,32,48,100,0.5404705821447979
60904,94,9409,12,Terminated,1820,1971,151,100,0.5404705821447979
61488,23,9531,3,Terminated,2046,2070,24,100,0.5404705821447979
61483,23,9531,3,Terminated,2046,2069,23,100,0.5404705821447979
61485,77,9531,3,Terminated,2046,2082,36,100,0.5404705821447979
61482,15,9531,3,Terminated,2046,2080,34,100,0.5404705821447979
61487,15,9531,3,Terminated,2046,2081,35,100,0.5404705821447979
62049,93,9580,10,Terminated,7280,7315,35,100,0.5404705821447979
62045,92,9580,10,Terminated,7280,7313,33,100,0.5404705821447979
62161,87,9592,10,Terminated,8100,8132,32,100,0.5404705821447979
62158,61,9592,10,Terminated,8100,8131,31,100,0.5404705821447979
62157,87,9592,10,Terminated,8100,8132,32,100,0.5404705821447979
62156,65,9592,10,Terminated,8100,8130,30,100,0.5404705821447979
62160,21,9592,10,Terminated,8100,8132,32,100,0.5404705821447979
62832,21,9632,12,Terminated,13114,13230,116,100,0.5736028783682341
62833,23,9632,12,Terminated,13114,13264,150,100,0.5736028783682341
62831,15,9632,12,Terminated,13114,13197,83,100,0.5404705821447979
63992,77,10197,8,Terminated,36090,36259,169,100,0.5404705821447979
64671,71,10350,3,Terminated,25244,25380,136,70,1.33564569150726
64699,64,10361,12,Terminated,36039,36207,168,70,1.33564569150726
64715,59,10369,10,Terminated,43231,43387,156,70,1.33564569150726
64767,70,10395,12,Terminated,57640,57713,73,65,1.6007040612947399
64777,69,10400,10,Terminated,57645,57729,84,75,1.33564569150726
64895,15,10422,8,Terminated,54967,54991,24,100,0.5404705821447979
64898,15,10422,8,Terminated,54967,54996,29,100,0.5404705821447979
64918,15,10430,8,Terminated,55322,55350,28,100,0.5404705821447979
64915,15,10430,8,Terminated,55322,55344,22,100,0.5404705821447979
64945,13,10442,8,Terminated,55853,55886,33,100,0.5404705821447979
64948,13,10442,8,Terminated,55853,55891,38,100,0.5404705821447979
64947,11,10442,8,Terminated,55853,55879,26,100,0.5404705821447979
64963,15,10448,12,Terminated,56524,56556,32,100,0.5404705821447979
64960,15,10448,12,Terminated,56524,56549,25,100,0.5404705821447979
64973,17,10452,8,Terminated,56696,56725,29,100,0.5404705821447979
64970,17,10452,8,Terminated,56696,56719,23,100,0.5404705821447979
64998,13,10462,10,Terminated,57097,57125,28,100,0.5404705821447979
64995,13,10462,10,Terminated,57097,57118,21,100,0.5404705821447979
65033,13,10476,12,Terminated,57714,57743,29,100,0.5404705821447979
65030,13,10476,12,Terminated,57714,57737,23,100,0.5404705821447979
65098,13,10501,8,Terminated,59039,59066,27,100,0.5404705821447979
65095,13,10501,8,Terminated,59039,59060,21,100,0.5404705821447979
65110,13,10507,10,Terminated,59279,59303,24,100,0.5404705821447979
65113,13,10507,10,Terminated,59279,59309,30,100,0.5404705821447979
65125,13,10513,12,Terminated,59527,59548,21,100,0.5404705821447979
65128,13,10513,12,Terminated,59527,59555,28,100,0.5404705821447979
65659,30,10615,12,Terminated,7472,7495,23,40,0.410012165765019
65661,31,10615,12,Terminated,7472,7539,67,40,1.6007040612947399
65660,31,10615,12,Terminated,7472,7517,45,40,1.6007040612947399
66408,47,10732,12,Terminated,46165,46256,91,100,0.5404705821447979
66407,23,10732,12,Terminated,46165,46249,84,100,0.5404705821447979
67035,19,10884,12,Terminated,35159,35308,149,100,0.275412212357311
67284,15,10925,3,Terminated,20557,20673,116,100,0.5404705821447979
67279,15,10925,3,Terminated,20557,20673,116,100,0.5404705821447979
67990,17,11079,3,Terminated,15922,16052,130,100,0.275412212357311
69277,25,11330,12,Terminated,1598,1645,47,100,0.5404705821447979
69283,59,11330,12,Terminated,1598,1704,106,100,0.5404705821447979
69279,29,11330,12,Terminated,1598,1675,77,100,0.5404705821447979
69280,23,11330,12,Terminated,1598,1645,47,100,0.5404705821447979
69718,85,11415,10,Terminated,27969,28137,168,100,0.5404705821447979
69717,85,11415,10,Terminated,27969,28116,147,100,0.5404705821447979
70860,27,11663,10,Terminated,51704,51750,46,100,0.5404705821447979
70881,27,11666,10,Terminated,51710,51778,68,100,0.5404705821447979
70923,27,11672,10,Terminated,51710,51823,113,100,0.5404705821447979
71449,61,11770,10,Terminated,2827,2864,37,100,0.5404705821447979
71452,10,11770,10,Terminated,2827,2864,37,100,0.5404705821447979
71444,97,11770,10,Terminated,2827,2869,42,100,0.5404705821447979
72252,10,11817,12,Terminated,53185,53222,37,100,0.5404705821447979
72251,25,11817,12,Terminated,53185,53224,39,100,0.5404705821447979
72248,33,11817,12,Terminated,53185,53227,42,100,0.5404705821447979
73070,77,11915,10,Terminated,32099,32255,156,100,0.275412212357311
73245,21,11930,3,Terminated,38437,38460,23,100,0.5404705821447979
73244,100,11930,3,Terminated,38437,38474,37,100,0.5404705821447979
73422,21,11955,3,Terminated,58331,58392,61,100,0.5404705821447979
73585,39,11973,8,Terminated,4811,4835,24,100,0.5404705821447979
73587,39,11973,8,Terminated,4811,4850,39,100,0.5404705821447979
73709,53,11986,10,Terminated,19831,19877,46,100,0.5404705821447979
73869,31,11993,10,Terminated,20211,20234,23,100,0.5404705821447979
74645,15,12078,10,Terminated,7002,7195,193,100,0.5404705821447979
74643,14,12078,10,Terminated,7002,7033,31,100,0.5404705821447979
74640,31,12078,10,Terminated,7002,7198,196,100,0.5404705821447979
74642,14,12078,10,Terminated,7002,7188,186,100,0.5404705821447979
74646,63,12079,8,Terminated,8087,8279,192,100,0.5404705821447979
74650,51,12079,8,Terminated,8087,8182,95,100,0.5404705821447979
74753,11,12095,12,Terminated,15274,15468,194,100,0.5404705821447979
74800,17,12101,3,Terminated,16521,16563,42,100,0.5404705821447979
74799,35,12101,3,Terminated,16521,16553,32,100,0.5404705821447979
74796,45,12101,3,Terminated,16521,16552,31,100,0.5404705821447979
74802,43,12101,3,Terminated,16521,16678,157,100,0.5404705821447979
74795,61,12101,3,Terminated,16521,16710,189,100,0.5404705821447979
74814,14,12103,3,Terminated,16547,16657,110,100,0.5404705821447979
74817,11,12103,3,Terminated,16547,16580,33,100,0.5404705821447979
74820,15,12103,3,Terminated,16547,16718,171,100,0.5404705821447979
74926,95,12112,12,Terminated,18078,18132,54,100,0.5404705821447979
74925,19,12112,12,Terminated,18078,18106,28,100,0.5404705821447979
74931,16,12112,12,Terminated,18078,18099,21,100,0.5404705821447979
74929,44,12112,12,Terminated,18078,18116,38,100,0.5404705821447979
74932,75,12112,12,Terminated,18078,18130,52,100,0.5404705821447979
78992,13,12677,3,Terminated,56730,56780,50,100,0.5404705821447979
78991,11,12677,3,Terminated,56730,56772,42,100,0.5404705821447979
707,25,125,12,Terminated,22633,22759,126,100,0.5404705821447979
706,71,125,12,Terminated,22633,22758,125,100,0.5404705821447979
991,49,178,8,Terminated,24167,24218,51,40,0.8008697227758651
1832,53,360,8,Terminated,29716,29846,130,55,0.9214919887143109
1837,69,360,8,Terminated,29716,29817,101,75,1.6007040612947399
1834,34,360,8,Terminated,29716,29773,57,75,1.33564569150726
1935,11,373,3,Terminated,51266,51434,168,40,0.417259855563896
1988,11,382,10,Terminated,53966,53997,31,65,1.33564569150726
1984,53,382,10,Terminated,53966,54087,121,70,0.923045065099785
1989,69,382,10,Terminated,53966,54140,174,75,1.6007040612947399
1986,34,382,10,Terminated,53966,54099,133,70,1.33564569150726
2091,55,403,8,Terminated,12326,12360,34,100,0.5404705821447979
2163,74,419,8,Terminated,19069,19177,108,40,0.7874097274350941
2258,11,435,3,Terminated,27578,27748,170,40,1.6007040612947399
2918,16,551,3,Terminated,34893,35050,157,100,0.275412212357311
3247,51,620,3,Terminated,34534,34628,94,100,0.5404705821447979
3275,51,628,10,Terminated,37793,37831,38,100,0.5404705821447979
5722,32,1028,12,Terminated,17573,17622,49,100,0.5404705821447979
5723,33,1028,12,Terminated,17573,17625,52,100,0.5404705821447979
8235,13,1423,3,Terminated,1613,1711,98,100,0.275412212357311
8280,10,1433,10,Terminated,2951,3140,189,100,0.275412212357311
8547,76,1510,12,Terminated,33821,33879,58,100,0.5404705821447979
8705,20,1566,8,Terminated,6380,6493,113,100,0.275412212357311
10556,14,1903,3,Terminated,54536,54646,110,100,0.5404705821447979
11147,26,1974,8,Terminated,35121,35178,57,100,0.5404705821447979
11159,30,1977,10,Terminated,38486,38598,112,100,0.5404705821447979
11162,60,1978,10,Terminated,40281,40407,126,100,0.5404705821447979
11718,11,2075,8,Terminated,27970,28039,69,100,0.5404705821447979
11726,11,2077,8,Terminated,29762,29844,82,100,0.5404705821447979
11749,43,2083,8,Terminated,35395,35500,105,100,0.5404705821447979
11750,45,2083,8,Terminated,35395,35503,108,100,0.5404705821447979
11798,55,2095,3,Terminated,45969,46070,101,100,0.5404705821447979
11797,53,2095,3,Terminated,45969,46067,98,100,0.5404705821447979
11838,39,2105,10,Terminated,55053,55139,86,100,0.5404705821447979
11837,37,2105,10,Terminated,55053,55139,86,100,0.5404705821447979
11846,57,2107,10,Terminated,56763,56849,86,100,0.5404705821447979
11845,55,2107,10,Terminated,56763,56847,84,100,0.5404705821447979
11949,11,2140,3,Terminated,5558,5600,42,100,0.5404705821447979
11950,11,2140,3,Terminated,5558,5603,45,100,1.6007040612947399
11943,11,2140,3,Terminated,5558,5592,34,100,1.63383635751818
12760,15,2238,12,Terminated,39690,39719,29,100,0.5404705821447979
12759,13,2238,12,Terminated,39690,39716,26,100,0.5404705821447979
12844,13,2243,3,Terminated,57664,57686,22,100,0.5404705821447979
12845,15,2243,3,Terminated,57664,57688,24,100,0.5404705821447979
13167,15,2312,10,Terminated,-80,-33,47,100,0.5404705821447979
13158,15,2312,10,Terminated,-80,-42,38,100,0.5404705821447979
13148,27,2312,10,Terminated,-80,1,81,100,0.5404705821447979
13147,25,2312,10,Terminated,-80,-7,73,100,0.5404705821447979
13145,17,2312,10,Terminated,-80,-24,56,100,0.5404705821447979
13146,19,2312,10,Terminated,-80,-15,65,100,0.5404705821447979
13543,11,2359,3,Terminated,4430,4460,30,100,0.5404705821447979
14411,11,2467,8,Terminated,11657,11694,37,100,0.5404705821447979
14820,11,2515,3,Terminated,14320,14356,36,100,0.5404705821447979
15114,83,2553,12,Terminated,17098,17203,105,100,1.07058732171977
16006,11,2654,10,Terminated,24384,24421,37,100,0.5404705821447979
17668,11,2858,3,Terminated,39881,39934,53,100,0.5404705821447979
17669,13,2858,3,Terminated,39881,39943,62,100,0.5404705821447979
17706,13,2862,8,Terminated,40432,40475,43,100,0.5404705821447979
17707,15,2862,8,Terminated,40432,40484,52,100,0.5404705821447979
17813,15,2874,3,Terminated,41310,41362,52,100,0.5404705821447979
17812,13,2874,3,Terminated,41310,41355,45,100,0.5404705821447979
18743,41,2987,10,Terminated,48718,48738,20,100,0.5404705821447979
18737,41,2987,10,Terminated,48718,48738,20,100,0.5404705821447979
18741,99,2987,10,Terminated,48718,48742,24,100,0.5404705821447979
18815,11,2996,3,Terminated,49594,49636,42,100,0.5404705821447979
18817,17,2996,3,Terminated,49594,49653,59,100,0.5404705821447979
18816,15,2996,3,Terminated,49594,49644,50,100,0.5404705821447979
18948,19,3009,3,Terminated,50481,50506,25,100,0.5404705821447979
18942,55,3009,3,Terminated,50481,50506,25,100,0.5404705821447979
18947,19,3009,3,Terminated,50481,50505,24,100,0.5404705821447979
19617,11,3086,3,Terminated,55909,55947,38,100,0.5404705821447979
19618,13,3086,3,Terminated,55909,55965,56,100,0.5404705821447979
19722,19,3097,3,Terminated,56796,56837,41,100,0.5404705821447979
19723,21,3097,3,Terminated,56796,56844,48,100,0.5404705821447979
19721,13,3097,3,Terminated,56796,56831,35,100,0.5404705821447979
19720,11,3097,3,Terminated,56796,56825,29,100,0.5404705821447979
19930,10,3127,3,Terminated,58446,58479,33,100,0.5404705821447979
19931,11,3127,3,Terminated,58446,58484,38,100,0.5404705821447979
19917,13,3127,3,Terminated,58446,58490,44,100,0.5404705821447979
19933,13,3129,12,Terminated,58449,58488,39,100,0.5404705821447979
19946,10,3129,12,Terminated,58449,58477,28,100,0.5404705821447979
19955,11,3129,12,Terminated,58449,58482,33,100,0.5404705821447979
19934,15,3129,12,Terminated,58449,58494,45,100,0.5404705821447979
20046,23,3147,8,Terminated,59339,59408,69,100,0.5404705821447979
20045,21,3147,8,Terminated,59339,59402,63,100,0.5404705821447979
20044,15,3147,8,Terminated,59339,59393,54,100,0.5404705821447979
20065,11,3147,8,Terminated,59339,59381,42,100,0.5404705821447979
20043,13,3147,8,Terminated,59339,59387,48,100,0.5404705821447979
20056,10,3147,8,Terminated,59339,59374,35,100,0.5404705821447979
20223,86,3174,12,Terminated,2415,2441,26,100,0.5404705821447979
20224,86,3174,12,Terminated,2415,2444,29,100,0.5404705821447979
20254,85,3181,12,Terminated,6017,6055,38,100,0.5404705821447979
22375,53,3731,12,Terminated,47124,47159,35,100,0.5404705821447979
22374,14,3731,12,Terminated,47124,47184,60,100,0.5404705821447979
22378,13,3731,12,Terminated,47124,47175,51,100,0.5404705821447979
22517,53,3767,8,Terminated,54872,54906,34,100,0.5404705821447979
22516,14,3767,8,Terminated,54872,54908,36,100,0.5404705821447979
22858,26,3865,8,Terminated,28990,29014,24,100,0.5404705821447979
31283,63,5008,8,Terminated,6251,6274,23,100,0.5404705821447979
31318,31,5011,8,Terminated,15252,15286,34,100,0.5404705821447979
31315,31,5011,8,Terminated,15252,15286,34,100,0.5404705821447979
31319,35,5011,8,Terminated,15252,15287,35,100,0.5404705821447979
31327,35,5012,12,Terminated,18910,18952,42,100,0.5404705821447979
31324,35,5012,12,Terminated,18910,18951,41,100,0.5404705821447979
31328,39,5012,12,Terminated,18910,18953,43,100,0.5404705821447979
31776,91,5070,3,Terminated,20629,20764,135,100,0.5404705821447979
31780,84,5070,3,Terminated,20629,20747,118,100,0.5404705821447979
31777,97,5070,3,Terminated,20629,20780,151,100,0.5404705821447979
31781,85,5070,3,Terminated,20629,20754,125,100,0.5404705821447979
31840,31,5076,8,Terminated,25939,25985,46,100,0.5404705821447979
31841,89,5076,8,Terminated,25939,25985,46,100,0.5404705821447979
31839,88,5076,8,Terminated,25939,25982,43,100,0.5404705821447979
31906,89,5089,8,Terminated,36935,36955,20,100,0.5404705821447979
31895,91,5089,8,Terminated,36935,36955,20,100,0.5404705821447979
31896,91,5089,8,Terminated,36935,36956,21,100,0.5404705821447979
31893,91,5089,8,Terminated,36935,36956,21,100,0.5404705821447979
32162,62,5129,10,Terminated,7487,7535,48,100,0.5404705821447979
32163,63,5129,10,Terminated,7487,7543,56,100,0.5404705821447979
32310,69,5164,8,Terminated,4838,4904,66,75,1.8657624310822298
32350,21,5177,12,Terminated,5778,5880,102,75,1.33564569150726
32356,21,5179,3,Terminated,5781,5877,96,75,1.33564569150726
32365,21,5182,10,Terminated,5784,5884,100,75,1.33564569150726
32374,29,5185,8,Terminated,5818,5892,74,75,1.33564569150726
32426,12,5202,12,Terminated,21927,22002,75,75,1.6007040612947399
32450,45,5210,8,Terminated,27430,27493,63,75,1.6007040612947399
32463,46,5214,10,Terminated,38422,38511,89,75,1.07058732171977
33918,14,5533,12,Terminated,31212,31376,164,100,0.275412212357311
34636,31,5664,10,Terminated,9037,9073,36,100,0.5404705821447979
34637,31,5664,10,Terminated,9037,9074,37,100,0.5404705821447979
34633,87,5664,10,Terminated,9037,9072,35,100,0.5404705821447979
36443,28,5975,8,Terminated,1287,1337,50,100,0.5404705821447979
36440,91,5975,8,Terminated,1287,1356,69,100,0.5404705821447979
36439,87,5975,8,Terminated,1287,1347,60,100,0.5404705821447979
37262,22,6181,8,Terminated,8350,8494,144,100,0.5404705821447979
37265,27,6181,8,Terminated,8350,8495,145,100,0.5404705821447979
37260,27,6181,8,Terminated,8350,8495,145,100,0.5404705821447979
37264,23,6181,8,Terminated,8350,8494,144,100,0.5404705821447979
37772,16,6258,10,Terminated,55415,55586,171,100,0.275412212357311
38454,92,6351,12,Terminated,6317,6359,42,100,0.275412212357311
41115,16,6957,3,Terminated,34980,35106,126,100,0.5404705821447979
41118,95,6957,3,Terminated,34980,35032,52,100,0.5404705821447979
41120,65,6957,3,Terminated,34980,35049,69,100,0.5404705821447979
41517,53,7036,12,Terminated,140,245,105,100,0.5404705821447979
41511,53,7036,12,Terminated,140,206,66,100,0.5404705821447979
41691,35,7059,8,Terminated,1388,1458,70,100,0.5404705821447979
41692,99,7059,8,Terminated,1388,1454,66,100,0.5404705821447979
41689,99,7059,8,Terminated,1388,1453,65,100,0.5404705821447979
60141,11,9108,10,Terminated,28840,28880,40,100,0.5404705821447979
60139,31,9108,10,Terminated,28840,28878,38,100,0.5404705821447979
60140,11,9108,10,Terminated,28840,28886,46,100,0.5404705821447979
60197,64,9120,12,Terminated,57633,57667,34,100,0.5404705821447979
60196,25,9120,12,Terminated,57633,57676,43,100,0.5404705821447979
60199,23,9120,12,Terminated,57633,57675,42,100,0.5404705821447979
60809,93,9391,12,Terminated,14316,14381,65,100,0.5404705821447979
60811,91,9391,12,Terminated,14316,14361,45,100,0.5404705821447979
60812,93,9391,12,Terminated,14316,14381,65,100,0.5404705821447979
61414,90,9515,10,Terminated,25512,25712,200,100,0.5404705821447979
61620,39,9552,8,Terminated,2821,2844,23,100,0.5404705821447979
61614,83,9552,8,Terminated,2821,2853,32,100,0.5404705821447979
61612,39,9552,8,Terminated,2821,2842,21,100,0.5404705821447979
61613,73,9552,8,Terminated,2821,2847,26,100,0.5404705821447979
61621,83,9552,8,Terminated,2821,2854,33,100,0.5404705821447979
63419,13,9759,12,Terminated,14891,14916,25,100,0.5404705821447979
63420,21,9759,12,Terminated,14891,14931,40,100,0.5404705821447979
63426,21,9759,12,Terminated,14891,14947,56,100,1.6007040612947399
63980,80,10195,12,Terminated,29847,29958,111,100,0.5404705821447979
64012,77,10202,12,Terminated,39162,39303,141,100,0.5404705821447979
64532,90,10321,8,Terminated,20625,20770,145,75,1.33564569150726
64580,84,10325,10,Terminated,90,141,51,75,1.33564569150726
64606,51,10331,3,Terminated,5861,5908,47,40,0.8034581834183209
64608,99,10331,3,Terminated,5861,6001,140,75,1.6007040612947399
64675,82,10352,8,Terminated,25245,25309,64,65,1.6007040612947399
64683,73,10356,8,Terminated,25250,25319,69,75,1.33564569150726
64709,71,10366,10,Terminated,36042,36128,86,70,1.33564569150726
64747,70,10385,3,Terminated,50454,50532,78,65,1.6007040612947399
64753,71,10388,10,Terminated,50456,50542,86,70,1.33564569150726
64773,71,10398,12,Terminated,57643,57703,60,70,1.33564569150726
64798,81,10403,10,Terminated,23444,23558,114,100,0.5404705821447979
64792,81,10403,10,Terminated,23444,23530,86,100,0.5404705821447979
64796,66,10403,10,Terminated,23444,23485,41,100,0.5404705821447979
64928,15,10434,3,Terminated,55497,55536,39,100,0.5404705821447979
64927,13,10434,3,Terminated,55497,55523,26,100,0.5404705821447979
64925,15,10434,3,Terminated,55497,55531,34,100,0.5404705821447979
64933,15,10436,3,Terminated,55583,55613,30,100,0.5404705821447979
64930,15,10436,3,Terminated,55583,55606,23,100,0.5404705821447979
64978,13,10454,8,Terminated,56776,56802,26,100,0.5404705821447979
64975,13,10454,8,Terminated,56776,56797,21,100,0.5404705821447979
64983,13,10456,10,Terminated,56858,56883,25,100,0.5404705821447979
65015,13,10470,3,Terminated,57433,57454,21,100,0.5404705821447979
65018,13,10470,3,Terminated,57434,57460,26,100,0.5404705821447979
65045,13,10481,3,Terminated,58252,58276,24,100,0.5404705821447979
65048,13,10481,3,Terminated,58252,58281,29,100,0.5404705821447979
65050,13,10483,10,Terminated,58332,58353,21,100,0.5404705821447979
65053,13,10483,10,Terminated,58333,58360,27,100,0.5404705821447979
65058,13,10485,10,Terminated,58411,58438,27,100,0.5404705821447979
65055,13,10485,10,Terminated,58411,58432,21,100,0.5404705821447979
65065,13,10489,12,Terminated,58569,58590,21,100,0.5404705821447979
65068,13,10489,12,Terminated,58569,58595,26,100,0.5404705821447979
65085,13,10497,8,Terminated,58882,58902,20,100,0.5404705821447979
65088,13,10497,8,Terminated,58882,58907,25,100,0.5404705821447979
65668,11,10616,8,Terminated,9607,9643,36,40,1.6007040612947399
65916,31,10633,12,Terminated,47488,47510,22,40,1.6007040612947399
65945,90,10640,3,Terminated,9220,9326,106,100,0.5404705821447979
66241,24,10703,8,Terminated,11012,11199,187,100,0.5404705821447979
66584,100,10787,8,Terminated,10600,10787,187,55,1.33564569150726
66703,93,10821,3,Terminated,42145,42258,113,100,0.5736028783682341
66702,95,10821,3,Terminated,42145,42297,152,100,0.5736028783682341
66807,15,10836,3,Terminated,50948,50972,24,100,0.5404705821447979
68840,63,11258,3,Terminated,43407,43507,100,100,0.5404705821447979
68834,63,11258,3,Terminated,43407,43504,97,100,0.5404705821447979
68837,60,11258,3,Terminated,43407,43497,90,100,0.5404705821447979
69445,11,11364,8,Terminated,14452,14617,165,100,0.5404705821447979
69444,11,11364,8,Terminated,14452,14615,163,100,0.5404705821447979
69446,11,11364,8,Terminated,14452,14621,169,100,0.5404705821447979
69443,11,11364,8,Terminated,14452,14626,174,100,0.5404705821447979
70735,59,11639,10,Terminated,50023,50211,188,100,0.275412212357311
70752,35,11643,8,Terminated,53439,53585,146,100,0.275412212357311
71244,46,11747,12,Terminated,51648,51687,39,100,0.5404705821447979
71249,93,11748,10,Terminated,52009,52031,22,100,0.5404705821447979
71246,97,11748,10,Terminated,52009,52088,79,100,0.5404705821447979
71380,61,11767,8,Terminated,847,886,39,100,0.5404705821447979
71383,10,11767,8,Terminated,847,884,37,100,0.5404705821447979
71375,97,11767,8,Terminated,847,890,43,100,0.5404705821447979
71546,81,11775,8,Terminated,9096,9138,42,100,0.5404705821447979
71541,73,11775,8,Terminated,9096,9137,41,100,0.5404705821447979
71549,10,11775,8,Terminated,9096,9137,41,100,0.5404705821447979
71948,25,11805,10,Terminated,37919,37957,38,100,0.5404705821447979
71945,33,11805,10,Terminated,37919,37955,36,100,0.5404705821447979
71949,10,11805,10,Terminated,37919,37952,33,100,0.5404705821447979
71972,33,11806,8,Terminated,40596,40645,49,100,0.5404705821447979
71976,10,11806,8,Terminated,40596,40639,43,100,0.5404705821447979
71975,25,11806,8,Terminated,40596,40643,47,100,0.5404705821447979
72030,10,11808,12,Terminated,44190,44223,33,100,0.5404705821447979
72029,27,11808,12,Terminated,44190,44227,37,100,0.5404705821447979
72026,33,11808,12,Terminated,44190,44227,37,100,0.5404705821447979
72708,12,11874,8,Terminated,23047,23111,64,100,0.275412212357311
72869,51,11895,8,Terminated,27247,27267,20,100,0.5404705821447979
73200,100,11927,3,Terminated,38092,38117,25,100,0.5404705821447979
74544,11,12064,10,Terminated,53715,53757,42,100,0.5404705821447979
74545,13,12064,10,Terminated,53715,53762,47,100,0.5404705821447979
76935,11,12506,10,Terminated,25833,25858,25,100,0.275412212357311
77425,49,12551,8,Terminated,34361,34381,20,100,0.5404705821447979
78311,11,12622,8,Terminated,47388,47422,34,100,0.275412212357311
1729,69,335,10,Terminated,171,326,155,60,1.6007040612947399
1726,34,335,10,Terminated,171,297,126,55,1.33564569150726
3058,34,573,3,Terminated,3887,3981,94,70,1.07058732171977
3067,74,573,3,Terminated,3887,4040,153,40,0.5736028783682341
3205,51,608,8,Terminated,29736,29769,33,100,0.5404705821447979
3312,51,637,10,Terminated,41437,41474,37,100,0.5404705821447979
3371,51,655,10,Terminated,49397,49432,35,100,0.5404705821447979
4484,31,884,3,Terminated,13370,13525,155,100,0.275412212357311
5031,25,974,3,Terminated,18067,18197,130,100,0.5736028783682341
5951,57,1077,3,Terminated,44558,44697,139,100,0.5404705821447979
5950,21,1077,3,Terminated,44558,44670,112,100,0.5404705821447979
5953,12,1077,3,Terminated,44558,44601,43,100,0.5404705821447979
5952,36,1077,3,Terminated,44558,44606,48,100,0.5404705821447979
5972,15,1083,12,Terminated,52594,52794,200,100,0.275412212357311
8069,31,1413,8,Terminated,29060,29160,100,100,0.5404705821447979
8068,90,1413,8,Terminated,29060,29159,99,100,0.5404705821447979
8456,35,1480,8,Terminated,25006,25140,134,100,0.5404705821447979
8457,35,1480,8,Terminated,25006,25166,160,100,0.5404705821447979
8455,100,1480,8,Terminated,25006,25093,87,100,0.5736028783682341
9921,19,1813,12,Terminated,23519,23623,104,100,0.5404705821447979
9920,19,1813,12,Terminated,23519,23618,99,100,0.5404705821447979
10086,21,1838,10,Terminated,14176,14357,181,100,0.5404705821447979
10079,21,1838,10,Terminated,14176,14328,152,100,0.5404705821447979
10085,16,1838,10,Terminated,14176,14234,58,100,0.5404705821447979
10355,16,1874,3,Terminated,33200,33262,62,100,0.5404705821447979
10349,21,1874,3,Terminated,33200,33373,173,100,0.5404705821447979
10483,35,1890,10,Terminated,46674,46722,48,100,0.5404705821447979
10487,29,1890,10,Terminated,46674,46721,47,100,0.5404705821447979
10486,19,1890,10,Terminated,46674,46720,46,100,0.5404705821447979
10874,23,1940,12,Terminated,24949,25016,67,100,0.5404705821447979
10875,32,1940,12,Terminated,24949,24991,42,100,0.5404705821447979
10877,33,1940,12,Terminated,24949,25011,62,100,0.5404705821447979
10873,43,1940,12,Terminated,24949,25068,119,100,0.5404705821447979
11468,17,2026,12,Terminated,15190,15216,26,100,0.5404705821447979
11473,16,2026,12,Terminated,15190,15210,20,100,0.5404705821447979
11472,13,2026,12,Terminated,15190,15278,88,100,0.5404705821447979
11746,29,2082,10,Terminated,34286,34414,128,100,0.5404705821447979
11745,27,2082,10,Terminated,34286,34414,128,100,0.5404705821447979
11802,27,2096,10,Terminated,46871,46953,82,100,0.5404705821447979
11801,25,2096,10,Terminated,46871,46951,80,100,0.5404705821447979
11973,57,2143,3,Terminated,6386,6416,30,100,0.5404705821447979
11974,59,2143,3,Terminated,6386,6422,36,100,0.5404705821447979
11987,59,2143,3,Terminated,6387,6431,44,100,0.5404705821447979
12810,13,2241,3,Terminated,50459,50495,36,100,0.5404705821447979
12811,15,2241,3,Terminated,50459,50497,38,100,0.5404705821447979
12865,45,2246,8,Terminated,5256,5368,112,100,0.5404705821447979
13581,11,2364,8,Terminated,5313,5342,29,100,0.5404705821447979
13654,33,2373,8,Terminated,6246,6296,50,100,1.07058732171977
13655,13,2373,8,Terminated,6246,6316,70,100,1.07058732171977
14342,11,2459,12,Terminated,10900,10926,26,100,0.5404705821447979
14347,11,2459,12,Terminated,10900,10926,26,100,0.5404705821447979
14349,13,2459,12,Terminated,10900,10925,25,100,0.5404705821447979
14350,25,2459,12,Terminated,10900,10927,27,100,0.5404705821447979
14343,13,2459,12,Terminated,10900,10925,25,100,0.5404705821447979
14557,11,2487,3,Terminated,12527,12560,33,100,0.5404705821447979
15395,11,2592,10,Terminated,19918,19970,52,100,0.5404705821447979
15768,11,2625,8,Terminated,22433,22473,40,100,0.5404705821447979
16579,11,2724,3,Terminated,30507,30550,43,100,0.5404705821447979
18113,74,2913,12,Terminated,43856,43981,125,100,0.275412212357311
19338,13,3054,10,Terminated,53945,53985,40,100,0.5404705821447979
19337,11,3054,10,Terminated,53945,53978,33,100,0.5404705821447979
20209,86,3172,12,Terminated,2321,2347,26,100,0.5404705821447979
20208,86,3172,12,Terminated,2321,2348,27,100,0.5404705821447979
20240,86,3176,12,Terminated,2670,2691,21,100,0.5404705821447979
20241,86,3176,12,Terminated,2670,2691,21,100,0.5404705821447979
21285,49,3475,12,Terminated,1859,1966,107,100,0.5404705821447979
21750,63,3581,10,Terminated,20746,20775,29,100,0.5404705821447979
21752,31,3581,10,Terminated,20746,20770,24,100,0.5404705821447979
21751,77,3581,10,Terminated,20746,20783,37,100,0.5404705821447979
22139,13,3678,10,Terminated,39864,39898,34,100,0.5404705821447979
22136,53,3678,10,Terminated,39864,39900,36,100,0.5404705821447979
22135,14,3678,10,Terminated,39864,39899,35,100,0.5404705821447979
31445,17,5028,8,Terminated,3099,3120,21,100,0.5404705821447979
31584,31,5037,12,Terminated,1418,1464,46,100,0.5404705821447979
31583,98,5037,12,Terminated,1418,1451,33,100,0.5736028783682341
31582,65,5037,12,Terminated,1418,1470,52,100,0.5404705821447979
31585,33,5037,12,Terminated,1418,1454,36,100,0.5404705821447979
31928,13,5094,8,Terminated,40744,40906,162,100,0.5404705821447979
31932,11,5094,8,Terminated,40744,40824,80,100,0.5404705821447979
32265,15,5148,3,Terminated,35207,35352,145,55,0.8081174125747409
32262,59,5148,3,Terminated,35207,35328,121,65,0.847462014340071
32264,17,5148,3,Terminated,35207,35294,87,75,1.07058732171977
32335,79,5172,3,Terminated,5383,5451,68,75,1.33564569150726
32531,11,5233,10,Terminated,2533,2589,56,100,1.07058732171977
32530,29,5233,10,Terminated,2533,2580,47,100,1.07058732171977
32566,39,5248,10,Terminated,3549,3611,62,100,1.07058732171977
32640,85,5275,12,Terminated,55945,55968,23,100,0.5404705821447979
32639,84,5275,12,Terminated,55945,55965,20,100,0.5404705821447979
32641,85,5275,12,Terminated,55945,55966,21,100,0.5404705821447979
33100,14,5415,10,Terminated,6227,6370,143,100,0.275412212357311
33207,91,5449,12,Terminated,8602,8695,93,100,0.5404705821447979
33208,86,5449,12,Terminated,8602,8672,70,100,0.5404705821447979
33870,14,5527,12,Terminated,31541,31664,123,100,0.275412212357311
34873,46,5696,3,Terminated,12705,12747,42,100,0.5404705821447979
35055,87,5721,10,Terminated,14998,15097,99,100,0.5404705821447979
35051,87,5721,10,Terminated,14998,15099,101,100,0.5404705821447979
35052,87,5721,10,Terminated,14998,15100,102,100,0.5404705821447979
35054,87,5721,10,Terminated,14998,15096,98,100,0.5404705821447979
35053,87,5721,10,Terminated,14998,15098,100,100,0.5404705821447979
35098,87,5726,3,Terminated,15750,15770,20,100,0.5404705821447979
36388,14,5961,12,Terminated,10214,10253,39,100,0.275412212357311
36394,24,5967,12,Terminated,10415,10465,50,100,0.275412212357311
36848,22,6076,12,Terminated,38511,38576,65,100,0.275412212357311
38210,19,6309,12,Terminated,37061,37194,133,100,0.5404705821447979
38193,19,6309,12,Terminated,37060,37186,126,100,0.5404705821447979
38192,13,6309,12,Terminated,37060,37176,116,100,0.5404705821447979
38314,19,6323,8,Terminated,39726,39853,127,100,0.5404705821447979
38296,13,6323,8,Terminated,39725,39832,107,100,0.5404705821447979
38297,19,6323,8,Terminated,39725,39843,118,100,0.5404705821447979
40446,11,6826,8,Terminated,55394,55494,100,100,0.5404705821447979
40490,11,6835,12,Terminated,55815,55882,67,100,0.5404705821447979
40656,71,6868,3,Terminated,2179,2276,97,100,0.5404705821447979
40658,66,6868,3,Terminated,2179,2265,86,100,0.5404705821447979
41742,33,7064,3,Terminated,1695,1892,197,100,0.5404705821447979
41736,35,7064,3,Terminated,1695,1893,198,100,0.5404705821447979
41733,35,7064,3,Terminated,1695,1881,186,100,0.5404705821447979
41744,33,7064,3,Terminated,1695,1869,174,100,0.5404705821447979
41743,33,7064,3,Terminated,1695,1881,186,100,0.5404705821447979
41738,33,7064,3,Terminated,1695,1889,194,100,0.5404705821447979
60119,96,9104,10,Terminated,14783,14826,43,100,0.5404705821447979
60124,97,9104,10,Terminated,14783,14842,59,100,0.5404705821447979
60155,15,9112,12,Terminated,39638,39705,67,100,0.5404705821447979
60152,17,9112,12,Terminated,39638,39711,73,100,0.5404705821447979
60153,43,9112,12,Terminated,39638,39700,62,100,0.5404705821447979
60180,21,9117,10,Terminated,54028,54067,39,100,0.5404705821447979
60177,23,9117,10,Terminated,54028,54068,40,100,0.5404705821447979
60178,59,9117,10,Terminated,54028,54061,33,100,0.5404705821447979
60770,96,9381,8,Terminated,8631,8810,179,100,0.5404705821447979
61260,33,9490,12,Terminated,2993,3017,24,100,0.5404705821447979
61268,33,9490,12,Terminated,2993,3020,27,100,0.5404705821447979
61266,13,9490,12,Terminated,2993,3021,28,100,0.5404705821447979
61267,13,9490,12,Terminated,2993,3027,34,100,0.5404705821447979
61526,37,9539,10,Terminated,2398,2438,40,100,0.5404705821447979
61527,73,9539,10,Terminated,2398,2439,41,100,0.5404705821447979
61528,77,9539,10,Terminated,2398,2442,44,100,0.5404705821447979
61529,81,9539,10,Terminated,2398,2445,47,100,0.5404705821447979
61551,29,9543,10,Terminated,2686,2744,58,100,0.5404705821447979
61552,20,9543,10,Terminated,2686,2744,58,100,0.5404705821447979
61555,29,9543,10,Terminated,2686,2744,58,100,0.5404705821447979
61554,21,9543,10,Terminated,2686,2744,58,100,0.5404705821447979
61563,39,9545,10,Terminated,2783,2810,27,100,0.5404705821447979
61569,35,9545,10,Terminated,2783,2805,22,100,0.5404705821447979
62304,55,9601,12,Terminated,8446,8583,137,100,0.5404705821447979
62306,55,9601,12,Terminated,8446,8580,134,100,0.5736028783682341
62305,22,9601,12,Terminated,8446,8468,22,100,0.5404705821447979
62751,61,9625,10,Terminated,12443,12492,49,100,0.5404705821447979
62816,73,9631,10,Terminated,13103,13241,138,100,0.5404705821447979
62817,73,9631,10,Terminated,13103,13241,138,100,0.5404705821447979
62815,63,9631,10,Terminated,13103,13142,39,100,0.5404705821447979
62824,73,9631,10,Terminated,13103,13241,138,100,0.5404705821447979
62823,73,9631,10,Terminated,13103,13243,140,100,0.5404705821447979
63356,11,9740,10,Terminated,2222,2265,43,40,1.6007040612947399
63409,11,9756,12,Terminated,11486,11553,67,100,0.5404705821447979
63456,28,9767,8,Terminated,20847,20954,107,100,1.07058732171977
63906,11,10175,10,Terminated,16081,16218,137,100,0.5404705821447979
63904,11,10175,10,Terminated,16081,16220,139,100,0.5404705821447979
63905,11,10175,10,Terminated,16081,16205,124,100,0.5404705821447979
63903,11,10175,10,Terminated,16081,16189,108,100,0.5404705821447979
63902,11,10175,10,Terminated,16081,16151,70,100,0.5404705821447979
63938,80,10187,8,Terminated,2668,2749,81,100,0.5404705821447979
64186,28,10238,3,Terminated,4034,4152,118,100,0.275412212357311
64577,56,10324,12,Terminated,-45,20,65,75,1.07058732171977
64677,70,10353,3,Terminated,25245,25332,87,75,1.33564569150726
64725,71,10374,8,Terminated,43306,43492,186,70,1.33564569150726
64733,70,10378,10,Terminated,43241,43363,122,75,1.33564569150726
64759,69,10391,12,Terminated,50511,50662,151,75,1.33564569150726
64761,59,10392,3,Terminated,57637,57758,121,70,1.33564569150726
64771,64,10397,12,Terminated,57643,57759,116,70,1.33564569150726
64821,50,10407,8,Terminated,24338,24480,142,55,1.6007040612947399
65060,13,10487,12,Terminated,58489,58510,21,100,0.5404705821447979
65063,13,10487,12,Terminated,58489,58516,27,100,0.5404705821447979
65120,13,10511,12,Terminated,59447,59468,21,100,0.5404705821447979
65123,13,10511,12,Terminated,59447,59474,27,100,0.5404705821447979
65455,14,10575,8,Terminated,25361,25554,193,100,0.275412212357311
65799,27,10624,3,Terminated,16254,16340,86,70,1.6007040612947399
65796,61,10624,3,Terminated,16254,16405,151,70,1.07058732171977
65807,25,10625,10,Terminated,17128,17275,147,75,1.07058732171977
65811,49,10625,10,Terminated,17128,17196,68,65,0.979991199233815
65944,55,10639,3,Terminated,8569,8644,75,100,0.5404705821447979
65943,46,10639,3,Terminated,8569,8601,32,100,0.5404705821447979
65941,55,10639,3,Terminated,8569,8626,57,100,0.5404705821447979
65947,90,10641,8,Terminated,9413,9560,147,100,0.5404705821447979
66243,17,10704,12,Terminated,12246,12282,36,100,0.5404705821447979
66244,64,10704,12,Terminated,12246,12395,149,100,1.6007040612947399
66364,17,10730,8,Terminated,37688,37712,24,100,0.5404705821447979
66586,71,10788,3,Terminated,10844,10952,108,60,1.33564569150726
66604,89,10797,3,Terminated,14999,15151,152,60,1.33564569150726
67888,11,11041,10,Terminated,10589,10726,137,100,0.275412212357311
68975,17,11270,3,Terminated,15187,15336,149,100,0.275412212357311
70355,21,11544,10,Terminated,42347,42381,34,100,0.5404705821447979
70349,69,11544,10,Terminated,42347,42442,95,100,0.5404705821447979
70347,21,11544,10,Terminated,42347,42376,29,100,0.5404705821447979
70348,67,11544,10,Terminated,42347,42437,90,100,0.5404705821447979
70353,46,11544,10,Terminated,42347,42421,74,100,0.5404705821447979
71270,99,11755,10,Terminated,56588,56659,71,100,0.5404705821447979
71269,99,11755,10,Terminated,56588,56647,59,100,0.5404705821447979
71275,99,11757,12,Terminated,59219,59241,22,100,0.5404705821447979
71518,97,11774,10,Terminated,7372,7405,33,100,0.5404705821447979
71526,10,11774,10,Terminated,7372,7405,33,100,0.5404705821447979
71523,61,11774,10,Terminated,7372,7408,36,100,0.5404705821447979
71667,18,11784,3,Terminated,16421,16471,50,100,0.5404705821447979
71864,33,11801,12,Terminated,36121,36166,45,100,0.5404705821447979
71866,25,11801,12,Terminated,36121,36167,46,100,0.5404705821447979
71867,10,11801,12,Terminated,36121,36161,40,100,0.5404705821447979
72194,33,11815,10,Terminated,49585,49633,48,100,0.5404705821447979
72197,25,11815,10,Terminated,49585,49626,41,100,0.5404705821447979
72198,10,11815,10,Terminated,49585,49629,44,100,0.5404705821447979
72576,19,11847,3,Terminated,12819,12999,180,100,0.275412212357311
72662,73,11863,10,Terminated,20828,20851,23,100,0.5404705821447979
73336,10,11942,8,Terminated,50412,50439,27,100,0.5404705821447979
74562,11,12065,3,Terminated,53800,53872,72,100,0.5404705821447979
74563,13,12065,3,Terminated,53800,53893,93,100,0.5404705821447979
74564,15,12065,3,Terminated,53800,53919,119,100,0.5404705821447979
74660,31,12080,3,Terminated,8227,8360,133,100,0.5404705821447979
74657,14,12080,3,Terminated,8227,8356,129,100,0.5404705821447979
74654,31,12080,3,Terminated,8227,8358,131,100,0.5404705821447979
75898,10,12320,3,Terminated,18719,18802,83,100,0.275412212357311
75939,44,12337,12,Terminated,4815,4965,150,100,0.275412212357311
77567,47,12562,10,Terminated,36204,36224,20,100,0.5404705821447979
77568,49,12562,10,Terminated,36204,36224,20,100,0.5404705821447979
78853,11,12664,10,Terminated,54750,54781,31,100,0.275412212357311
630,53,109,8,Terminated,52203,52255,52,100,0.5404705821447979
623,17,109,8,Terminated,52203,52372,169,100,0.5404705821447979
1779,54,347,8,Terminated,14302,14343,41,100,0.5404705821447979
2104,25,405,3,Terminated,12815,12869,54,40,0.812258949602671
2102,25,405,3,Terminated,12815,12854,39,40,1.6007040612947399
2922,13,553,3,Terminated,33492,33658,166,100,0.275412212357311
3177,51,600,10,Terminated,25797,25832,35,100,0.5404705821447979
3191,51,604,8,Terminated,27821,27858,37,100,0.5404705821447979
3219,51,612,8,Terminated,30988,31031,43,100,0.5404705821447979
3385,51,659,10,Terminated,51350,51392,42,100,0.5404705821447979
3401,51,664,12,Terminated,53023,53069,46,100,0.5404705821447979
3487,41,688,3,Terminated,8323,8369,46,100,0.5404705821447979
5064,11,984,10,Terminated,9880,9943,63,100,0.275412212357311
5275,75,996,10,Terminated,1194,1294,100,100,0.5404705821447979
5247,60,996,10,Terminated,1194,1248,54,100,0.5404705821447979
5590,87,998,3,Terminated,3750,3903,153,100,0.5404705821447979
5564,60,998,3,Terminated,3749,3850,101,100,0.5404705821447979
7705,13,1310,8,Terminated,42174,42214,40,100,0.5404705821447979
7707,13,1310,8,Terminated,42174,42222,48,100,0.5404705821447979
7726,17,1314,3,Terminated,49561,49591,30,100,0.5404705821447979
7724,17,1314,3,Terminated,49561,49584,23,100,0.5404705821447979
7731,19,1316,3,Terminated,53179,53200,21,100,0.5404705821447979
7733,19,1316,3,Terminated,53179,53202,23,100,0.5404705821447979
8027,16,1402,10,Terminated,42377,42518,141,100,0.275412212357311
8875,20,1615,10,Terminated,40197,40389,192,100,0.275412212357311
8882,21,1619,12,Terminated,38847,38993,146,100,0.5404705821447979
8892,21,1619,12,Terminated,38847,38994,147,100,0.5404705821447979
8885,19,1619,12,Terminated,38847,38993,146,100,0.5404705821447979
8884,17,1619,12,Terminated,38847,38992,145,100,0.5404705821447979
9132,10,1680,12,Terminated,19998,20048,50,100,0.5404705821447979
10066,16,1835,12,Terminated,14173,14238,65,100,0.5404705821447979
10075,16,1836,3,Terminated,14326,14436,110,100,0.5404705821447979
10383,16,1877,8,Terminated,37767,37915,148,100,0.5404705821447979
10404,19,1881,12,Terminated,41044,41089,45,100,0.5404705821447979
10401,41,1881,12,Terminated,41044,41093,49,100,0.5404705821447979
10405,29,1881,12,Terminated,41044,41090,46,100,0.5404705821447979
11086,12,1964,8,Terminated,4877,4999,122,100,0.5404705821447979
11155,69,1976,10,Terminated,36785,36917,132,65,1.6007040612947399
11184,18,1982,10,Terminated,54814,54851,37,55,1.33564569150726
11492,83,2030,8,Terminated,17579,17601,22,100,0.5404705821447979
11493,20,2030,8,Terminated,17579,17646,67,100,0.5404705821447979
11626,11,2052,10,Terminated,3682,3757,75,100,0.5404705821447979
11742,21,2081,10,Terminated,33372,33523,151,100,0.5404705821447979
11741,19,2081,10,Terminated,33372,33522,150,100,0.5404705821447979
11766,55,2087,3,Terminated,38839,38933,94,100,0.5404705821447979
11765,53,2087,3,Terminated,38839,38932,93,100,0.5404705821447979
11805,35,2097,8,Terminated,47773,47849,76,100,0.5404705821447979
11806,37,2097,8,Terminated,47773,47850,77,100,0.5404705821447979
11849,27,2108,10,Terminated,57752,57832,80,100,0.5404705821447979
11850,29,2108,10,Terminated,57752,57833,81,100,0.5404705821447979
11953,57,2142,12,Terminated,5965,5985,20,100,0.5404705821447979
11964,23,2142,12,Terminated,5965,5995,30,100,0.5404705821447979
11967,59,2142,12,Terminated,5965,5991,26,100,0.5404705821447979
11956,19,2142,12,Terminated,5965,5995,30,100,0.5404705821447979
11954,59,2142,12,Terminated,5965,5986,21,100,0.5404705821447979
12106,35,2156,3,Terminated,20473,20584,111,100,0.5736028783682341
12103,85,2156,3,Terminated,20473,20505,32,100,0.5736028783682341
12861,12,2245,8,Terminated,1019,1172,153,100,0.275412212357311
13357,11,2336,3,Terminated,2314,2350,36,100,0.5404705821447979
13661,60,2376,12,Terminated,6589,6666,77,100,0.275412212357311
14461,11,2473,10,Terminated,11830,11859,29,100,0.5404705821447979
14462,15,2473,10,Terminated,11830,11858,28,100,0.5404705821447979
14468,15,2473,10,Terminated,11830,11858,28,100,0.5404705821447979
14466,11,2473,10,Terminated,11830,11859,29,100,0.5404705821447979
14469,27,2473,10,Terminated,11830,11860,30,100,0.5404705821447979
14724,11,2506,8,Terminated,13587,13619,32,100,0.5404705821447979
14794,13,2510,3,Terminated,14010,14116,106,100,0.5404705821447979
14759,13,2510,3,Terminated,14010,14084,74,100,0.5404705821447979
14784,12,2510,3,Terminated,14011,14109,98,100,0.5404705821447979
15238,20,2573,8,Terminated,21493,21568,75,100,0.275412212357311
16334,11,2695,12,Terminated,27987,28019,32,100,0.5404705821447979
16386,11,2701,10,Terminated,28691,28726,35,100,0.5404705821447979
16949,29,2768,3,Terminated,33420,33443,23,100,0.5404705821447979
16954,29,2768,3,Terminated,33420,33444,24,100,0.5404705821447979
16956,39,2768,3,Terminated,33420,33442,22,100,0.5404705821447979
16957,69,2768,3,Terminated,33420,33445,25,100,0.5404705821447979
16950,39,2768,3,Terminated,33420,33442,22,100,0.5404705821447979
18337,11,2942,12,Terminated,45173,45198,25,100,0.5404705821447979
18347,11,2943,3,Terminated,45804,45859,55,100,0.5404705821447979
18535,11,2964,12,Terminated,46959,46980,21,100,0.5404705821447979
18800,11,2994,3,Terminated,49584,49628,44,100,0.5404705821447979
19864,11,3120,3,Terminated,57734,57766,32,100,0.5404705821447979
19863,10,3120,3,Terminated,57734,57761,27,100,0.5404705821447979
19851,15,3120,3,Terminated,57734,57778,44,100,0.5404705821447979
19850,13,3120,3,Terminated,57733,57772,39,100,0.5404705821447979
21949,11,3627,12,Terminated,28571,28760,189,100,0.275412212357311
21967,11,3630,3,Terminated,29536,29586,50,100,0.5404705821447979
21966,29,3630,3,Terminated,29536,29580,44,100,0.5404705821447979
21964,41,3630,3,Terminated,29536,29693,157,100,0.5404705821447979
21965,29,3630,3,Terminated,29536,29565,29,100,0.5404705821447979
23065,74,3885,3,Terminated,25175,25198,23,100,0.275412212357311
31339,76,5013,10,Terminated,27261,27282,21,100,1.6007040612947399
31745,19,5064,12,Terminated,17178,17309,131,100,0.5404705821447979
31749,16,5064,12,Terminated,17179,17269,90,100,0.5404705821447979
32151,63,5127,3,Terminated,2091,2152,61,100,0.5404705821447979
32150,62,5127,3,Terminated,2091,2145,54,100,0.5404705821447979
32199,63,5135,12,Terminated,18298,18354,56,100,0.5404705821447979
32198,63,5135,12,Terminated,18298,18346,48,100,0.5404705821447979
32223,63,5139,12,Terminated,25474,25530,56,100,0.5404705821447979
32222,63,5139,12,Terminated,25474,25522,48,100,0.5404705821447979
32234,51,5141,3,Terminated,36278,36340,62,100,0.5404705821447979
32235,51,5141,3,Terminated,36278,36349,71,100,0.5404705821447979
32267,35,5150,10,Terminated,34176,34348,172,100,0.275412212357311
32359,21,5180,10,Terminated,5783,5894,111,75,1.33564569150726
32389,21,5189,12,Terminated,5922,5999,77,75,1.33564569150726
32423,12,5201,12,Terminated,21924,22000,76,75,1.6007040612947399
32429,12,5203,12,Terminated,21926,22005,79,75,1.6007040612947399
32459,81,5212,10,Terminated,32659,32800,141,75,1.07058732171977
32458,37,5212,10,Terminated,32659,32744,85,75,1.33564569150726
32460,46,5213,12,Terminated,38410,38473,63,75,1.07058732171977
32559,39,5245,10,Terminated,3449,3481,32,100,1.07058732171977
33034,71,5398,3,Terminated,2081,2153,72,100,0.5404705821447979
33031,71,5398,3,Terminated,2081,2151,70,100,0.5404705821447979
33154,48,5434,12,Terminated,7392,7577,185,100,0.275412212357311
33698,27,5500,8,Terminated,14454,14528,74,100,0.5404705821447979
33701,27,5500,8,Terminated,14454,14608,154,100,0.5404705821447979
33700,27,5500,8,Terminated,14454,14591,137,100,0.5404705821447979
33697,78,5500,8,Terminated,14454,14487,33,100,0.5404705821447979
33699,27,5500,8,Terminated,14454,14568,114,100,0.5404705821447979
35831,40,5830,10,Terminated,52286,52486,200,100,0.5404705821447979
35997,17,5859,8,Terminated,7520,7667,147,100,0.5404705821447979
36386,16,5959,10,Terminated,10928,11119,191,100,0.275412212357311
36679,100,6036,8,Terminated,27868,27939,71,100,0.5404705821447979
36909,17,6087,8,Terminated,46042,46232,190,100,0.5404705821447979
36910,11,6087,8,Terminated,46042,46188,146,100,0.5404705821447979
36912,17,6087,8,Terminated,46042,46234,192,100,0.5404705821447979
37231,51,6174,12,Terminated,2346,2390,44,100,0.5404705821447979
37229,51,6174,12,Terminated,2346,2383,37,100,0.5404705821447979
37230,51,6174,12,Terminated,2345,2390,45,100,0.5404705821447979
37279,27,6183,10,Terminated,9280,9427,147,100,0.5404705821447979
37273,25,6183,10,Terminated,9280,9415,135,100,0.5404705821447979
37274,27,6183,10,Terminated,9280,9420,140,100,0.5404705821447979
37276,23,6183,10,Terminated,9280,9403,123,100,0.5404705821447979
37278,23,6183,10,Terminated,9280,9409,129,100,0.5404705821447979
37655,10,6241,8,Terminated,47648,47782,134,100,0.275412212357311
37941,70,6283,8,Terminated,28858,28881,23,100,0.5404705821447979
37943,77,6283,8,Terminated,28858,29022,164,100,0.5404705821447979
38092,87,6300,8,Terminated,35861,35997,136,100,0.5404705821447979
38091,83,6300,8,Terminated,35861,35989,128,100,0.5404705821447979
38097,24,6300,8,Terminated,35862,35894,32,100,0.5404705821447979
38094,24,6300,8,Terminated,35862,35889,27,100,0.5404705821447979
38478,18,6352,8,Terminated,6044,6066,22,100,0.5404705821447979
38456,11,6352,8,Terminated,6043,6067,24,100,0.5404705821447979
38482,75,6352,8,Terminated,6043,6068,25,100,0.5404705821447979
38483,21,6352,8,Terminated,6043,6065,22,100,0.5404705821447979
41919,16,7080,12,Terminated,5970,6115,145,100,0.275412212357311
60163,19,9114,10,Terminated,46833,46877,44,100,0.5404705821447979
60161,51,9114,10,Terminated,46833,46867,34,100,0.5404705821447979
60160,21,9114,10,Terminated,46833,46878,45,100,0.5404705821447979
60939,27,9426,10,Terminated,10856,10890,34,100,0.5404705821447979
60941,79,9426,10,Terminated,10856,10890,34,100,0.5404705821447979
60938,79,9426,10,Terminated,10856,10890,34,100,0.5404705821447979
60954,79,9431,3,Terminated,12646,12717,71,100,0.5404705821447979
60955,79,9431,3,Terminated,12646,12725,79,100,0.5404705821447979
61400,83,9512,8,Terminated,8931,9010,79,100,0.5404705821447979
61401,32,9512,8,Terminated,8931,8982,51,100,0.5404705821447979
61402,38,9512,8,Terminated,8931,8955,24,100,0.5404705821447979
61403,11,9512,8,Terminated,8931,8988,57,100,0.5404705821447979
61399,71,9512,8,Terminated,8931,8987,56,100,0.5404705821447979
61473,15,9529,8,Terminated,1985,2078,93,100,0.5404705821447979
61474,69,9529,8,Terminated,1985,2078,93,100,0.5404705821447979
61471,14,9529,8,Terminated,1985,2078,93,100,0.5404705821447979
61469,69,9529,8,Terminated,1985,2078,93,100,0.5404705821447979
61501,29,9535,12,Terminated,2241,2272,31,100,0.5404705821447979
61502,29,9535,12,Terminated,2241,2287,46,100,0.5404705821447979
61497,33,9535,12,Terminated,2241,2307,66,100,0.5404705821447979
61512,35,9536,10,Terminated,2337,2418,81,100,0.5404705821447979
61503,20,9536,10,Terminated,2337,2419,82,100,0.5404705821447979
61504,35,9536,10,Terminated,2337,2418,81,100,0.5404705821447979
61506,35,9536,10,Terminated,2337,2418,81,100,0.5404705821447979
61508,35,9536,10,Terminated,2337,2419,82,100,0.5404705821447979
61510,35,9536,10,Terminated,2337,2419,82,100,0.5404705821447979
61627,11,9553,3,Terminated,3062,3100,38,100,0.5404705821447979
61915,43,9569,8,Terminated,6210,6332,122,100,0.5404705821447979
61918,43,9569,8,Terminated,6210,6296,86,100,0.5404705821447979
62738,55,9623,12,Terminated,10873,10972,99,100,0.5404705821447979
62737,19,9623,12,Terminated,10873,10970,97,100,0.5404705821447979
62743,35,9623,12,Terminated,10873,10894,21,100,0.5404705821447979
62740,11,9623,12,Terminated,10873,10924,51,100,0.5404705821447979
62744,19,9623,12,Terminated,10873,10971,98,100,0.5404705821447979
62933,16,9637,12,Terminated,3730,3854,124,100,0.275412212357311
64229,36,10256,10,Terminated,41012,41065,53,100,0.275412212357311
64252,21,10260,3,Terminated,39746,39795,49,100,0.5404705821447979
64245,13,10260,3,Terminated,39746,39791,45,100,0.5404705821447979
64246,21,10260,3,Terminated,39746,39795,49,100,0.5404705821447979
64568,11,10323,3,Terminated,25156,25306,150,75,1.33564569150726
64631,19,10336,8,Terminated,8274,8398,124,40,0.8055289519322859
64679,21,10354,8,Terminated,25244,25316,72,60,1.33564569150726
64695,59,10359,8,Terminated,36044,36215,171,70,1.33564569150726
64775,72,10399,8,Terminated,57646,57709,63,75,1.33564569150726
64988,13,10458,10,Terminated,56935,56961,26,100,0.5404705821447979
64985,13,10458,10,Terminated,56935,56956,21,100,0.5404705821447979
65003,13,10464,8,Terminated,57180,57209,29,100,0.5404705821447979
65000,13,10464,8,Terminated,57180,57203,23,100,0.5404705821447979
65008,13,10466,12,Terminated,57260,57289,29,100,0.5404705821447979
65005,13,10466,12,Terminated,57260,57282,22,100,0.5404705821447979
65023,13,10472,10,Terminated,57522,57551,29,100,0.5404705821447979
65020,13,10472,10,Terminated,57522,57545,23,100,0.5404705821447979
65028,21,10474,10,Terminated,57612,57656,44,100,0.5404705821447979
65027,19,10474,10,Terminated,57612,57645,33,100,0.5404705821447979
65025,21,10474,10,Terminated,57612,57651,39,100,0.5404705821447979
65070,13,10491,12,Terminated,58651,58674,23,100,0.5404705821447979
65073,13,10491,12,Terminated,58651,58680,29,100,0.5404705821447979
65078,13,10493,3,Terminated,58725,58751,26,100,0.5404705821447979
65075,13,10493,3,Terminated,58725,58746,21,100,0.5404705821447979
66367,17,10731,12,Terminated,46163,46311,148,100,0.5404705821447979
66368,41,10731,12,Terminated,46163,46317,154,100,0.5404705821447979
66446,25,10733,12,Terminated,46694,46792,98,100,0.5404705821447979
66447,27,10733,12,Terminated,46694,46807,113,100,0.5404705821447979
66448,15,10733,12,Terminated,46694,46735,41,100,0.5404705821447979
66449,17,10733,12,Terminated,46694,46756,62,100,0.5404705821447979
66450,19,10733,12,Terminated,46694,46775,81,100,0.5404705821447979
67435,12,10962,12,Terminated,36913,37083,170,100,0.275412212357311
69353,27,11343,3,Terminated,13680,13833,153,100,0.5404705821447979
69360,15,11343,3,Terminated,13680,13728,48,100,0.5404705821447979
69356,14,11343,3,Terminated,13680,13719,39,100,0.5404705821447979
70762,19,11645,12,Terminated,55039,55178,139,100,0.275412212357311
70839,27,11660,12,Terminated,51710,51783,73,100,0.5404705821447979
70902,27,11669,8,Terminated,51710,51888,178,100,0.5404705821447979
70986,27,11681,3,Terminated,51722,51848,126,100,0.5404705821447979
71363,10,11765,3,Terminated,13096,13135,39,100,0.5404705821447979
71500,61,11773,3,Terminated,5499,5544,45,100,0.5404705821447979
71503,10,11773,3,Terminated,5499,5541,42,100,0.5404705821447979
71495,97,11773,3,Terminated,5499,5542,43,100,0.5404705821447979
71633,51,11780,12,Terminated,13688,13747,59,100,0.5404705821447979
71634,51,11780,12,Terminated,13688,13765,77,100,0.5404705821447979
71841,10,11800,3,Terminated,35186,35228,42,100,0.5404705821447979
71838,33,11800,3,Terminated,35186,35232,46,100,0.5404705821447979
71840,25,11800,3,Terminated,35186,35229,43,100,0.5404705821447979
72225,10,11816,3,Terminated,51396,51441,45,100,0.5404705821447979
72221,33,11816,3,Terminated,51396,51444,48,100,0.5404705821447979
72224,25,11816,3,Terminated,51396,51443,47,100,0.5404705821447979
72530,53,11844,8,Terminated,11644,11725,81,100,0.5404705821447979
72537,57,11844,8,Terminated,11644,11745,101,100,0.5404705821447979
72531,47,11844,8,Terminated,11644,11669,25,100,0.5404705821447979
72535,53,11844,8,Terminated,11644,11726,82,100,0.5404705821447979
72536,53,11844,8,Terminated,11644,11729,85,100,0.5404705821447979
72593,89,11851,8,Terminated,12897,12918,21,100,0.5736028783682341
72588,25,11851,8,Terminated,12897,12933,36,100,0.5404705821447979
73042,16,11911,8,Terminated,31785,31957,172,100,0.275412212357311
73353,10,11943,3,Terminated,50496,50557,61,100,0.5404705821447979
73654,91,11983,12,Terminated,19802,19825,23,100,0.5404705821447979
74620,13,12073,10,Terminated,3864,4040,176,100,0.5404705821447979
74613,19,12073,10,Terminated,3864,4041,177,100,0.5404705821447979
74612,13,12073,10,Terminated,3864,3898,34,100,0.5404705821447979
74614,25,12073,10,Terminated,3864,4042,178,100,0.5404705821447979
74619,13,12073,10,Terminated,3864,4034,170,100,0.5736028783682341
74781,39,12099,10,Terminated,15687,15798,111,100,0.5404705821447979
74785,37,12099,10,Terminated,15687,15797,110,100,0.5404705821447979
74784,35,12099,10,Terminated,15687,15759,72,100,0.5404705821447979
74780,37,12099,10,Terminated,15687,15797,110,100,0.5404705821447979
77241,11,12534,12,Terminated,33102,33135,33,100,0.275412212357311
77289,11,12537,8,Terminated,33155,33191,36,100,0.275412212357311
78256,11,12616,8,Terminated,47309,47338,29,100,0.275412212357311
78410,13,12634,10,Terminated,49491,49533,42,100,0.5404705821447979
78409,11,12634,10,Terminated,49491,49524,33,100,0.5404705821447979
78551,11,12644,10,Terminated,50748,50777,29,100,0.5404705821447979
2295,11,445,10,Terminated,49844,50018,174,40,1.6007040612947399
3147,51,591,3,Terminated,20661,20702,41,100,0.5404705821447979
3357,51,651,8,Terminated,47698,47738,40,100,0.5404705821447979
5068,29,985,10,Terminated,17416,17467,51,100,0.5404705821447979
5897,53,1063,10,Terminated,33827,33964,137,100,0.5404705821447979
7486,13,1279,3,Terminated,30411,30606,195,100,0.275412212357311
7714,15,1312,3,Terminated,46154,46181,27,100,0.5404705821447979
7712,15,1312,3,Terminated,46154,46180,26,100,0.5404705821447979
8759,35,1595,12,Terminated,14468,14603,135,100,0.5404705821447979
8775,19,1595,12,Terminated,14468,14603,135,100,0.5404705821447979
8758,19,1595,12,Terminated,14468,14603,135,100,0.5404705821447979
8766,15,1595,12,Terminated,14468,14535,67,100,0.5404705821447979
8757,19,1595,12,Terminated,14468,14586,118,100,0.5404705821447979
9592,91,1755,12,Terminated,480,508,28,100,0.5404705821447979
9593,91,1755,12,Terminated,480,507,27,100,0.5404705821447979
9587,27,1755,12,Terminated,480,505,25,100,0.5404705821447979
9586,91,1755,12,Terminated,480,507,27,100,0.5404705821447979
11090,18,1965,12,Terminated,6019,6129,110,40,0.7832681904071641
11324,91,2008,10,Terminated,6449,6479,30,100,0.5404705821447979
11328,93,2008,10,Terminated,6449,6497,48,100,0.5404705821447979
11320,93,2008,10,Terminated,6449,6496,47,100,0.5404705821447979
11327,93,2008,10,Terminated,6449,6496,47,100,0.5404705821447979
11629,11,2053,12,Terminated,5462,5530,68,100,0.5404705821447979
11630,13,2053,12,Terminated,5462,5530,68,100,0.5404705821447979
11822,39,2101,3,Terminated,51373,51469,96,100,0.5404705821447979
11821,37,2101,3,Terminated,51373,51468,95,100,0.5404705821447979
11830,57,2103,3,Terminated,53161,53254,93,100,0.5404705821447979
11829,55,2103,3,Terminated,53161,53253,92,100,0.5404705821447979
11858,47,2110,12,Terminated,59518,59594,76,100,0.5404705821447979
11857,45,2110,12,Terminated,59518,59591,73,100,0.5404705821447979
12828,15,2242,8,Terminated,54090,54118,28,100,0.5404705821447979
12827,13,2242,8,Terminated,54090,54116,26,100,0.5404705821447979
13170,19,2314,8,Terminated,-92,-34,58,100,0.5404705821447979
13183,15,2314,8,Terminated,-92,-47,45,100,0.5404705821447979
13182,15,2314,8,Terminated,-92,-53,39,100,0.5404705821447979
13169,17,2314,8,Terminated,-92,-41,51,100,0.5404705821447979
13658,33,2374,12,Terminated,6376,6522,146,100,1.07058732171977
13659,96,2374,12,Terminated,6376,6440,64,100,1.07058732171977
14228,11,2444,10,Terminated,9819,9852,33,100,0.5404705821447979
15111,29,2552,3,Terminated,17005,17037,32,100,1.07058732171977
15110,83,2552,3,Terminated,17005,17026,21,100,1.07058732171977
15682,16,2615,10,Terminated,21985,22112,127,100,0.275412212357311
17238,39,2801,10,Terminated,36136,36158,22,100,0.5404705821447979
18363,15,2945,10,Terminated,45811,45868,57,100,0.5404705821447979
18364,17,2945,10,Terminated,45811,45876,65,100,0.5404705821447979
18362,11,2945,10,Terminated,45811,45860,49,100,0.5404705821447979
18568,11,2967,8,Terminated,47625,47667,42,100,0.5404705821447979
18847,11,2999,8,Terminated,49643,49663,20,100,0.5404705821447979
19745,13,3099,8,Terminated,56796,56839,43,100,0.5404705821447979
19744,11,3099,8,Terminated,56796,56834,38,100,0.5404705821447979
19866,13,3122,10,Terminated,57742,57774,32,100,0.5404705821447979
19888,11,3122,10,Terminated,57743,57769,26,100,0.5404705821447979
19879,10,3122,10,Terminated,57743,57764,21,100,0.5404705821447979
19869,23,3122,10,Terminated,57743,57794,51,100,0.5404705821447979
19868,21,3122,10,Terminated,57743,57787,44,100,0.5404705821447979
19867,15,3122,10,Terminated,57742,57780,38,100,0.5404705821447979
20439,70,3236,10,Terminated,27029,27068,39,100,0.5404705821447979
22287,11,3711,10,Terminated,42533,42644,111,100,0.275412212357311
22486,11,3757,3,Terminated,53656,53767,111,100,0.275412212357311
23112,88,3894,8,Terminated,25683,25730,47,100,0.5404705821447979
23111,22,3894,8,Terminated,25683,25741,58,100,0.5404705821447979
26145,72,4304,8,Terminated,47557,47577,20,100,0.275412212357311
32101,11,5117,10,Terminated,53398,53557,159,100,0.5404705821447979
32204,63,5136,10,Terminated,20075,20120,45,100,0.5404705821447979
32205,63,5136,10,Terminated,20075,20127,52,100,0.5404705821447979
32217,63,5138,10,Terminated,23663,23736,73,100,0.5404705821447979
32216,63,5138,10,Terminated,23663,23727,64,100,0.5404705821447979
32316,69,5166,10,Terminated,4843,4910,67,75,1.8657624310822298
32333,26,5171,10,Terminated,4938,5124,186,75,1.8657624310822298
32334,63,5171,10,Terminated,4938,4979,41,75,1.8657624310822298
32347,25,5176,12,Terminated,5690,5771,81,100,0.5404705821447979
32362,21,5181,10,Terminated,5783,5879,96,75,1.33564569150726
32435,12,5205,8,Terminated,21935,22013,78,75,1.6007040612947399
32469,46,5216,10,Terminated,38424,38521,97,75,1.07058732171977
32472,46,5217,12,Terminated,38434,38520,86,75,1.07058732171977
32498,90,5219,12,Terminated,2321,2352,31,100,1.07058732171977
32499,31,5219,12,Terminated,2321,2372,51,100,1.07058732171977
32516,45,5226,12,Terminated,2441,2502,61,100,1.07058732171977
34817,77,5690,10,Terminated,11042,11153,111,100,0.5404705821447979
34818,77,5690,10,Terminated,11042,11159,117,100,0.5404705821447979
34899,77,5702,10,Terminated,12327,12382,55,100,0.5404705821447979
34902,76,5702,10,Terminated,12327,12380,53,100,0.5404705821447979
34922,31,5704,10,Terminated,12552,12573,21,100,0.5404705821447979
34924,37,5704,10,Terminated,12552,12575,23,100,0.5404705821447979
35779,59,5821,10,Terminated,51209,51239,30,100,0.5404705821447979
35783,19,5821,10,Terminated,51209,51238,29,100,0.5404705821447979
35784,57,5821,10,Terminated,51209,51237,28,100,0.5404705821447979
35780,79,5821,10,Terminated,51209,51241,32,100,0.5404705821447979
35781,56,5821,10,Terminated,51209,51236,27,100,0.5404705821447979
35785,79,5821,10,Terminated,51209,51245,36,100,0.5404705821447979
36121,89,5895,8,Terminated,22662,22696,34,100,0.5404705821447979
36123,34,5895,8,Terminated,22662,22687,25,100,0.5404705821447979
36122,49,5895,8,Terminated,22662,22682,20,100,0.5404705821447979
36126,87,5895,8,Terminated,22662,22695,33,100,0.5404705821447979
36120,87,5895,8,Terminated,22662,22694,32,100,0.5404705821447979
36119,37,5895,8,Terminated,22662,22692,30,100,0.5404705821447979
36549,10,5997,8,Terminated,2971,3154,183,100,0.275412212357311
37350,65,6194,3,Terminated,24147,24188,41,100,0.5404705821447979
37351,65,6194,3,Terminated,24147,24197,50,100,0.5404705821447979
37352,65,6194,3,Terminated,24147,24197,50,100,0.5404705821447979
38063,37,6297,10,Terminated,34633,34747,114,100,0.5404705821447979
38062,35,6297,10,Terminated,34633,34734,101,100,0.5404705821447979
38073,24,6297,10,Terminated,34634,34658,24,100,0.5404705821447979
38061,11,6297,10,Terminated,34633,34715,82,100,0.5404705821447979
38064,49,6297,10,Terminated,34633,34759,126,100,0.5404705821447979
38106,19,6302,12,Terminated,36600,36721,121,100,0.5404705821447979
38123,19,6302,12,Terminated,36601,36728,127,100,0.5404705821447979
38105,13,6302,12,Terminated,36600,36709,109,100,0.5404705821447979
38441,35,6345,8,Terminated,5982,6004,22,100,1.07058732171977
40211,11,6773,8,Terminated,54082,54155,73,100,0.5404705821447979
40365,11,6807,12,Terminated,55127,55204,77,100,0.5404705821447979
40370,11,6808,8,Terminated,55139,55213,74,100,0.5404705821447979
40475,11,6832,8,Terminated,55756,55849,93,100,0.5404705821447979
59889,30,9090,12,Terminated,57888,57908,20,100,0.5404705821447979
60176,19,9116,3,Terminated,50430,50477,47,100,0.5404705821447979
60174,55,9116,3,Terminated,50430,50464,34,100,0.5404705821447979
60173,21,9116,3,Terminated,50430,50478,48,100,0.5404705821447979
60947,24,9428,12,Terminated,10900,10987,87,100,0.5404705821447979
61034,10,9469,3,Terminated,25126,25293,167,100,0.275412212357311
64189,13,10240,12,Terminated,11091,11196,105,100,0.275412212357311
64493,49,10316,8,Terminated,7553,7632,79,40,0.788962803820568
64524,90,10320,3,Terminated,19994,20123,129,75,1.33564569150726
64584,21,10326,10,Terminated,305,484,179,100,0.5404705821447979
64583,59,10326,10,Terminated,305,428,123,100,0.5404705821447979
64601,14,10329,8,Terminated,2496,2668,172,100,0.5404705821447979
64673,67,10351,12,Terminated,25246,25363,117,70,1.33564569150726
64703,21,10363,8,Terminated,36041,36114,73,60,1.33564569150726
64721,70,10372,10,Terminated,43233,43317,84,65,1.6007040612947399
64741,59,10382,8,Terminated,50451,50635,184,70,1.33564569150726
64887,13,10418,3,Terminated,54778,54800,22,100,0.5404705821447979
64888,15,10418,3,Terminated,54778,54813,35,100,0.5404705821447979
64885,15,10418,3,Terminated,54778,54807,29,100,0.5404705821447979
64912,15,10428,8,Terminated,55234,55260,26,100,0.5404705821447979
64913,17,10428,8,Terminated,55234,55272,38,100,0.5404705821447979
64910,17,10428,8,Terminated,55234,55266,32,100,0.5404705821447979
64922,13,10432,10,Terminated,55400,55425,25,100,0.5404705821447979
64920,15,10432,10,Terminated,55400,55432,32,100,0.5404705821447979
64923,15,10432,10,Terminated,55400,55438,38,100,0.5404705821447979
64940,17,10440,3,Terminated,55757,55789,32,100,0.5404705821447979
64942,15,10440,3,Terminated,55757,55782,25,100,0.5404705821447979
64943,17,10440,3,Terminated,55758,55796,38,100,0.5404705821447979
64968,17,10450,12,Terminated,56614,56644,30,100,0.5404705821447979
64965,17,10450,12,Terminated,56614,56638,24,100,0.5404705821447979
65013,13,10468,3,Terminated,57347,57375,28,100,0.5404705821447979
65010,13,10468,3,Terminated,57347,57370,23,100,0.5404705821447979
65105,13,10505,10,Terminated,59200,59223,23,100,0.5404705821447979
65108,13,10505,10,Terminated,59200,59230,30,100,0.5404705821447979
65319,51,10543,12,Terminated,1865,1908,43,100,0.5404705821447979
65318,51,10543,12,Terminated,1865,1909,44,100,0.5404705821447979
65720,80,10620,10,Terminated,11235,11279,44,40,1.6007040612947399
65935,90,10636,8,Terminated,5978,6024,46,100,0.5404705821447979
65936,31,10636,8,Terminated,5978,6061,83,100,0.5404705821447979
68577,12,11230,8,Terminated,8877,8967,90,100,0.275412212357311
69427,43,11360,12,Terminated,14388,14436,48,100,0.5404705821447979
69429,42,11360,12,Terminated,14388,14420,32,100,0.5404705821447979
69431,43,11360,12,Terminated,14388,14444,56,100,0.5404705821447979
69432,43,11360,12,Terminated,14388,14446,58,100,0.5404705821447979
69762,17,11424,8,Terminated,30651,30826,175,100,0.5404705821447979
69760,11,11424,8,Terminated,30651,30687,36,100,0.5404705821447979
69757,17,11424,8,Terminated,30651,30799,148,100,0.5404705821447979
70818,27,11657,12,Terminated,51724,51860,136,100,0.5404705821447979
70944,27,11675,8,Terminated,51723,51853,130,100,0.5404705821447979
71007,27,11684,8,Terminated,51723,51862,139,100,0.5404705821447979
71240,12,11746,12,Terminated,51350,51536,186,100,0.275412212357311
72003,10,11807,3,Terminated,41500,41540,40,100,0.5404705821447979
72002,25,11807,3,Terminated,41500,41539,39,100,0.5404705821447979
71999,33,11807,3,Terminated,41500,41543,43,100,0.5404705821447979
72141,25,11813,10,Terminated,46909,46947,38,100,0.5404705821447979
72142,10,11813,10,Terminated,46909,46943,34,100,0.5404705821447979
72138,33,11813,10,Terminated,46909,46946,37,100,0.5404705821447979
72628,59,11854,12,Terminated,13138,13287,149,100,0.5736028783682341
72624,51,11854,12,Terminated,13138,13159,21,100,0.5736028783682341
74232,81,12034,12,Terminated,8462,8655,193,100,0.5404705821447979
75642,23,12283,3,Terminated,11677,11702,25,100,0.5404705821447979
75885,10,12314,10,Terminated,7510,7571,61,100,0.275412212357311
89,10,18,3,Terminated,11792,11958,166,50,1.33564569150726
86,27,18,3,Terminated,11792,11846,54,50,1.6007040612947399
149,11,27,8,Terminated,16281,16343,62,50,0.8707581601221751
138,15,27,8,Terminated,16281,16338,57,50,0.853156627753475
142,54,27,8,Terminated,16281,16328,47,50,0.8050112598037941
405,25,57,3,Terminated,23307,23377,70,50,1.33564569150726
410,37,57,3,Terminated,23307,23351,44,50,0.813812025988144
408,47,57,3,Terminated,23307,23332,25,50,0.8055289519322859
513,51,74,12,Terminated,29862,29909,47,50,1.6007040612947399
669,21,116,12,Terminated,54068,54150,82,50,0.784821266792638
668,67,116,12,Terminated,54068,54143,75,50,0.7863743431781111
672,28,116,12,Terminated,54068,54123,55,50,1.6007040612947399
670,17,116,12,Terminated,54068,54092,24,50,1.6007040612947399
1106,74,200,12,Terminated,46232,46325,93,50,1.33564569150726
1107,59,200,12,Terminated,46232,46369,137,50,1.6007040612947399
1315,11,233,8,Terminated,10827,10862,35,50,0.5736028783682341
1316,63,233,8,Terminated,10827,10864,37,50,0.8019051070328471
1351,32,251,10,Terminated,29722,29796,74,50,0.5736028783682341
1352,63,251,10,Terminated,29722,29802,80,50,0.8019051070328471
1355,33,253,8,Terminated,30627,30698,71,50,0.5736028783682341
1356,63,253,8,Terminated,30627,30704,77,50,0.8019051070328471
1401,63,265,10,Terminated,36032,36156,124,50,0.8019051070328471
1400,39,265,10,Terminated,36032,36149,117,50,0.5736028783682341
1622,44,322,3,Terminated,49195,49392,197,50,1.6007040612947399
1670,44,328,8,Terminated,49213,49251,38,50,1.6007040612947399
1694,44,331,8,Terminated,49223,49254,31,50,1.6007040612947399
1702,44,332,10,Terminated,49253,49283,30,50,1.6007040612947399
1798,11,352,10,Terminated,15220,15303,83,50,1.33564569150726
1796,12,352,10,Terminated,15220,15354,134,50,0.41518908704993107
2895,39,546,3,Terminated,30867,30951,84,50,1.6007040612947399
2898,33,546,3,Terminated,30867,31054,187,50,1.6007040612947399
2894,25,546,3,Terminated,30867,30947,80,50,1.6007040612947399
2964,25,560,12,Terminated,37666,37736,70,50,1.6007040612947399
3466,14,684,3,Terminated,12808,12835,27,50,1.6007040612947399
3551,71,707,8,Terminated,24610,24686,76,50,0.8055289519322859
3588,85,713,10,Terminated,43778,43928,150,50,0.8055289519322859
3814,33,755,3,Terminated,276,330,54,50,1.07058732171977
3824,33,757,12,Terminated,328,355,27,50,1.07058732171977
3823,33,757,12,Terminated,328,520,192,50,1.33564569150726
3929,33,778,10,Terminated,2052,2106,54,50,1.07058732171977
3934,33,779,12,Terminated,2073,2148,75,50,1.07058732171977
3974,33,787,8,Terminated,2404,2460,56,50,1.07058732171977
3973,34,787,8,Terminated,2404,2450,46,50,1.33564569150726
3975,13,787,8,Terminated,2404,2462,58,50,0.7853389589211289
3978,33,788,10,Terminated,2423,2447,24,50,1.33564569150726
3979,33,788,10,Terminated,2423,2443,20,50,1.07058732171977
3980,13,788,10,Terminated,2423,2459,36,50,0.7853389589211289
3984,33,789,10,Terminated,2444,2473,29,50,1.07058732171977
3985,13,789,10,Terminated,2444,2529,85,50,0.7853389589211289
3983,33,789,10,Terminated,2444,2514,70,50,1.33564569150726
3994,33,791,8,Terminated,2534,2624,90,50,1.07058732171977
4028,33,798,3,Terminated,3054,3097,43,50,1.33564569150726
4029,33,798,3,Terminated,3054,3104,50,50,1.07058732171977
4030,13,798,3,Terminated,3054,3110,56,50,0.7853389589211289
4064,33,805,12,Terminated,3436,3531,95,50,1.07058732171977
4069,33,806,12,Terminated,3482,3519,37,50,1.07058732171977
4080,13,808,10,Terminated,4361,4434,73,50,0.7853389589211289
4079,33,808,10,Terminated,4361,4418,57,50,1.07058732171977
4078,33,808,10,Terminated,4361,4414,53,50,1.33564569150726
4094,33,811,3,Terminated,4461,4522,61,50,1.07058732171977
4123,33,817,12,Terminated,5835,5863,28,50,1.33564569150726
4125,13,817,12,Terminated,5835,5881,46,50,0.7853389589211289
4124,33,817,12,Terminated,5835,5861,26,50,1.07058732171977
4134,33,819,10,Terminated,5846,5926,80,50,1.07058732171977
4174,33,827,10,Terminated,6045,6146,101,50,1.07058732171977
4243,33,841,8,Terminated,7398,7425,27,50,1.33564569150726
4244,33,841,8,Terminated,7398,7418,20,50,1.07058732171977
4245,13,841,8,Terminated,7398,7443,45,50,0.7853389589211289
4268,33,846,8,Terminated,8480,8644,164,50,1.33564569150726
4269,33,846,8,Terminated,8480,8554,74,50,1.07058732171977
4342,33,859,8,Terminated,9349,9373,24,50,1.07058732171977
4341,33,859,8,Terminated,9349,9385,36,50,1.33564569150726
4343,13,859,8,Terminated,9348,9401,53,50,0.7853389589211289
4362,33,863,12,Terminated,9465,9518,53,50,1.07058732171977
4372,33,865,12,Terminated,9770,9793,23,50,1.07058732171977
4373,13,865,12,Terminated,9770,9816,46,50,0.7853389589211289
4371,33,865,12,Terminated,9770,9798,28,50,1.33564569150726
4510,15,886,3,Terminated,13154,13300,146,50,0.7858566510496201
4495,34,886,3,Terminated,13154,13281,127,50,1.07058732171977
4512,15,886,3,Terminated,13154,13300,146,50,0.7858566510496201
4508,13,886,3,Terminated,13154,13298,144,50,0.7858566510496201
4549,33,890,3,Terminated,13882,13952,70,50,1.07058732171977
4554,33,891,8,Terminated,14186,14258,72,50,1.07058732171977
4605,33,901,12,Terminated,17469,17527,58,50,1.07058732171977
4618,33,905,3,Terminated,20892,20926,34,50,1.07058732171977
4720,33,913,10,Terminated,25750,25813,63,50,1.07058732171977
4744,33,917,12,Terminated,29143,29225,82,50,1.07058732171977
4814,33,931,8,Terminated,39922,40019,97,50,1.07058732171977
6104,64,1121,10,Terminated,9536,9710,174,50,1.33564569150726
6812,37,1189,8,Terminated,45241,45346,105,50,1.07058732171977
6820,55,1189,8,Terminated,45241,45350,109,50,1.07058732171977
7210,91,1240,12,Terminated,25026,25134,108,50,0.866616623094245
7207,71,1240,12,Terminated,25026,25161,135,50,0.9261512178707321
7209,42,1240,12,Terminated,25026,25118,92,50,1.33564569150726
7211,29,1240,12,Terminated,25026,25196,170,50,0.792068956591515
7424,23,1273,3,Terminated,27956,28010,54,50,1.6007040612947399
7440,80,1274,10,Terminated,27993,28193,200,50,1.6007040612947399
7801,27,1340,3,Terminated,23392,23515,123,50,0.863510470323298
7876,23,1367,3,Terminated,36018,36062,44,50,1.6007040612947399
7880,11,1368,3,Terminated,38246,38319,73,50,1.6007040612947399
8096,20,1416,8,Terminated,16972,17028,56,50,0.8055289519322859
8099,26,1416,8,Terminated,16972,17027,55,50,0.8433204773121421
8115,26,1417,8,Terminated,17085,17167,82,50,0.8433204773121421
8112,20,1417,8,Terminated,17085,17171,86,50,0.8055289519322859
8247,11,1426,8,Terminated,1748,1774,26,50,0.41933062407786
8311,93,1444,8,Terminated,5496,5579,83,50,0.9981104237310071
8355,93,1453,8,Terminated,9126,9209,83,50,0.997075039474024
8458,39,1481,12,Terminated,25088,25182,94,50,1.33564569150726
9103,85,1676,8,Terminated,20247,20331,84,50,1.6007040612947399
9540,38,1745,3,Terminated,50442,50558,116,50,1.6007040612947399
9539,29,1745,3,Terminated,50442,50621,179,50,2.13082080086972
