task_name,instance_num,job_name,task_type,status,start_time,end_time,duration,plan_cpu,plan_mem
task_LTg0MTUwNTA5Mjg4MDkwNjIzMA==,11,j_374403,10,Terminated,129604,129769,165,75,0.1
task_OTg1NjA1OTIxMzA4ODkxNg==,71,j_88285,8,Terminated,151218,151248,30,100,0.59
task_ODYzMjgxNTM3NDQ2NzUwMjQxMg==,25,j_88285,8,Terminated,151218,151279,61,100,0.59
task_ODYzMjgxNTM3NDQ2NzUwMjQxMg==,17,j_386584,8,Terminated,216019,216094,75,100,0.59
task_OTg1NjA1OTIxMzA4ODkxNg==,47,j_386584,8,Terminated,216019,216065,46,100,0.59
task_ODYzMjgxNTM3NDQ2NzUwMjQxMg==,25,j_888119,8,Terminated,583220,583276,56,100,0.59
task_OTg1NjA1OTIxMzA4ODkxNg==,71,j_888119,8,Terminated,583220,583249,29,100,0.59
task_ODYzMjgxNTM3NDQ2NzUwMjQxMg==,25,j_581430,8,Terminated,410422,410470,48,100,0.59
task_LTg0MTUwNTA5Mjg4MDkwNjIzMA==,12,j_391121,10,Terminated,561624,561658,34,100,0.1
task_OTg1NjA1OTIxMzA4ODkxNg==,23,j_323551,8,Terminated,108025,108210,185,100,0.59
task_ODYzMjgxNTM3NDQ2NzUwMjQxMg==,17,j_104903,8,Terminated,561625,561672,47,100,0.59
task_OTg1NjA1OTIxMzA4ODkxNg==,23,j_528396,8,Terminated,108025,108192,167,100,0.59
task_ODYzMjgxNTM3NDQ2NzUwMjQxMg==,17,j_559106,8,Terminated,388826,388887,61,100,0.59
task_OTg1NjA1OTIxMzA4ODkxNg==,47,j_559106,8,Terminated,388826,388849,23,100,0.59
task_OTg1NjA1OTIxMzA4ODkxNg==,23,j_490241,8,Terminated,540033,540069,36,100,0.59
task_LTg0MTUwNTA5Mjg4MDkwNjIzMA==,13,j_499929,10,Terminated,583235,583272,37,100,0.1
task_LTg0MTUwNTA5Mjg4MDkwNjIzMA==,13,j_423333,10,Terminated,475238,475276,38,100,0.1
task_LTg0MTUwNTA5Mjg4MDkwNjIzMA==,23,j_561333,10,Terminated,561639,561675,36,100,0.1
task_LTg0MTUwNTA5Mjg4MDkwNjIzMA==,53,j_268800,10,Terminated,561642,561676,34,100,0.1
task_ODYzMjgxNTM3NDQ2NzUwMjQxMg==,25,j_103252,8,Terminated,237643,237725,82,100,0.59
task_OTg1NjA1OTIxMzA4ODkxNg==,71,j_103252,8,Terminated,237643,237681,38,100,0.59
task_LTg0MTUwNTA5Mjg4MDkwNjIzMA==,83,j_430242,10,Terminated,302451,302505,54,100,0.1
task_LTI0MjU2NDM0NTE3NDI0MzkwNjE=,22,j_407507,3,Terminated,280863,280915,52,100,0.39
task_MzQwMDQzNjY0MzkwNzU2ODYyMg==,61,j_391757,3,Terminated,367263,367300,37,100,0.31
task_LTg0MTUwNTA5Mjg4MDkwNjIzMA==,14,j_89441,10,Terminated,583264,583303,39,100,0.1
task_OTg1NjA1OTIxMzA4ODkxNg==,99,j_139415,8,Terminated,475264,475442,178,100,0.59
task_MzQwMDQzNjY0MzkwNzU2ODYyMg==,22,j_407507,3,Terminated,280866,280887,21,100,0.39
task_LTg0MTUwNTA5Mjg4MDkwNjIzMA==,13,j_709125,10,Terminated,583271,583318,47,100,0.1
task_ODg3NTU4NTE3NDcxODA4NjA5Ng==,40,j_529988,3,Terminated,194489,194566,77,100,0.39
task_LTg0MTUwNTA5Mjg4MDkwNjIzMA==,16,j_229513,10,Terminated,302493,302519,26,100,0.1
task_LTg0MTUwNTA5Mjg4MDkwNjIzMA==,18,j_61993,10,Terminated,648097,648122,25,100,0.1
task_LTg0MTUwNTA5Mjg4MDkwNjIzMA==,89,j_212781,10,Terminated,561700,561739,39,100,0.1
task_LTg0MTUwNTA5Mjg4MDkwNjIzMA==,22,j_63255,10,Terminated,561703,561737,34,100,0.1
task_LTg0MTUwNTA5Mjg4MDkwNjIzMA==,13,j_322977,10,Terminated,561706,561748,42,100,0.1
task_LTg0MTUwNTA5Mjg4MDkwNjIzMA==,11,j_494258,10,Terminated,561719,561747,28,100,0.1
task_LTg0MTUwNTA5Mjg4MDkwNjIzMA==,12,j_347099,10,Terminated,583327,583354,27,100,0.1
task_LTg0MTUwNTA5Mjg4MDkwNjIzMA==,13,j_336384,10,Terminated,561727,561770,43,100,0.1
task_LTg0MTUwNTA5Mjg4MDkwNjIzMA==,18,j_373821,10,Terminated,129732,129763,31,100,0.1
task_LTg0MTUwNTA5Mjg4MDkwNjIzMA==,14,j_423156,10,Terminated,561748,561777,29,100,0.1
task_LTg0MTUwNTA5Mjg4MDkwNjIzMA==,13,j_573948,10,Terminated,583359,583392,33,100,0.1
task_LTg0MTUwNTA5Mjg4MDkwNjIzMA==,16,j_724356,10,Terminated,561764,561794,30,100,0.1
task_LTg0MTUwNTA5Mjg4MDkwNjIzMA==,11,j_636402,10,Terminated,302581,302636,55,100,0.1
task_LTg0MTUwNTA5Mjg4MDkwNjIzMA==,52,j_69249,10,Terminated,496987,497007,20,100,0.1
task_LTg0MTUwNTA5Mjg4MDkwNjIzMA==,13,j_208297,10,Terminated,583390,583417,27,100,0.1
task_LTg0MTUwNTA5Mjg4MDkwNjIzMA==,11,j_601030,10,Terminated,151392,151414,22,100,0.1
task_LTg0MTUwNTA5Mjg4MDkwNjIzMA==,16,j_157701,10,Terminated,129798,129838,40,100,0.1
task_LTg0MTUwNTA5Mjg4MDkwNjIzMA==,22,j_836498,10,Terminated,129808,129848,40,100,0.1
task_LTg0MTUwNTA5Mjg4MDkwNjIzMA==,21,j_680631,10,Terminated,151424,151449,25,100,0.1
task_LTg0MTUwNTA5Mjg4MDkwNjIzMA==,73,j_790174,10,Terminated,561837,561870,33,100,0.1
task_LTg0MTUwNTA5Mjg4MDkwNjIzMA==,44,j_879269,10,Terminated,129852,129882,30,100,0.1
task_LTg0MTUwNTA5Mjg4MDkwNjIzMA==,29,j_43943,8,Terminated,216266,216286,20,100,0.1
task_LTg0MTUwNTA5Mjg4MDkwNjIzMA==,17,j_564648,10,Terminated,648272,648295,23,100,0.1
task_LTg0MTUwNTA5Mjg4MDkwNjIzMA==,13,j_812981,10,Terminated,583478,583499,21,100,0.1
task_LTg0MTUwNTA5Mjg4MDkwNjIzMA==,20,j_210930,10,Terminated,129898,129931,33,100,0.1
task_LTg0MTUwNTA5Mjg4MDkwNjIzMA==,25,j_427562,10,Terminated,302698,302725,27,100,0.1
task_LTg0MTUwNTA5Mjg4MDkwNjIzMA==,11,j_216084,10,Terminated,237900,237921,21,100,0.1
task_LTg0MTUwNTA5Mjg4MDkwNjIzMA==,21,j_895625,10,Terminated,302709,302755,46,100,0.1
task_LTg0MTUwNTA5Mjg4MDkwNjIzMA==,29,j_755115,10,Terminated,648323,648356,33,100,0.1
task_OTg1NjA1OTIxMzA4ODkxNg==,24,j_836289,8,Terminated,216326,216434,108,100,0.59
task_LTg0MTUwNTA5Mjg4MDkwNjIzMA==,72,j_24610,10,Terminated,561953,561996,43,100,0.1
task_MzQwMDQzNjY0MzkwNzU2ODYyMg==,20,j_861722,3,Terminated,605158,605184,26,100,0.77
task_LTI0MjU2NDM0NTE3NDI0MzkwNjE=,100,j_861722,3,Terminated,605159,605268,109,100,0.77
task_LTg0MTUwNTA5Mjg4MDkwNjIzMA==,61,j_706850,10,Terminated,561969,561998,29,100,0.1
task_LTg0MTUwNTA5Mjg4MDkwNjIzMA==,21,j_539668,10,Terminated,151579,151605,26,100,0.1
task_LTg0MTUwNTA5Mjg4MDkwNjIzMA==,13,j_602463,10,Terminated,583587,583611,24,100,0.1
task_MzQwMDQzNjY0MzkwNzU2ODYyMg==,20,j_148687,3,Terminated,86788,86845,57,100,0.77
task_LTI0MjU2NDM0NTE3NDI0MzkwNjE=,38,j_699674,3,Terminated,562010,562066,56,100,0.39
task_ODYzMjgxNTM3NDQ2NzUwMjQxMg==,33,j_506798,8,Terminated,432416,432480,64,100,0.59
task_ODYzMjgxNTM3NDQ2NzUwMjQxMg==,33,j_4505,8,Terminated,346054,346134,80,100,0.59
task_OTg1NjA1OTIxMzA4ODkxNg==,96,j_4505,8,Terminated,346054,346092,38,100,0.59
task_LTI0MjU2NDM0NTE3NDI0MzkwNjE=,19,j_795846,3,Terminated,670061,670108,47,100,0.39
task_LTg0MTUwNTA5Mjg4MDkwNjIzMA==,44,j_316089,10,Terminated,475666,475689,23,100,0.1
task_LTg0MTUwNTA5Mjg4MDkwNjIzMA==,22,j_117149,10,Terminated,302884,302931,47,100,0.1
task_LTg0MTUwNTA5Mjg4MDkwNjIzMA==,25,j_678944,10,Terminated,302897,302932,35,100,0.1
task_LTI0MjU2NDM0NTE3NDI0MzkwNjE=,44,j_79155,3,Terminated,216500,216574,74,100,0.39
task_MzQwMDQzNjY0MzkwNzU2ODYyMg==,44,j_79155,3,Terminated,216500,216534,34,100,0.39
task_LTg0MTUwNTA5Mjg4MDkwNjIzMA==,19,j_456544,10,Terminated,648503,648551,48,100,0.1
task_LTg0MTUwNTA5Mjg4MDkwNjIzMA==,28,j_711883,10,Terminated,562117,562152,35,100,0.1
task_LTg0MTUwNTA5Mjg4MDkwNjIzMA==,18,j_395513,10,Terminated,648526,648552,26,100,0.1
task_LTg0MTUwNTA5Mjg4MDkwNjIzMA==,52,j_197053,10,Terminated,562173,562227,54,100,0.1
task_LTg0MTUwNTA5Mjg4MDkwNjIzMA==,18,j_458069,10,Terminated,648574,648600,26,100,0.1
task_LTg0MTUwNTA5Mjg4MDkwNjIzMA==,93,j_703720,10,Terminated,648596,648628,32,100,0.1
task_LTg0MTUwNTA5Mjg4MDkwNjIzMA==,10,j_155266,10,Terminated,130208,130240,32,100,0.1
task_LTg0MTUwNTA5Mjg4MDkwNjIzMA==,50,j_131871,10,Terminated,216641,216667,26,100,0.1
task_LTg0MTUwNTA5Mjg4MDkwNjIzMA==,81,j_110428,10,Terminated,130267,130298,31,100,0.1
task_LTg0MTUwNTA5Mjg4MDkwNjIzMA==,13,j_55149,10,Terminated,475876,475906,30,100,0.1
task_LTg0MTUwNTA5Mjg4MDkwNjIzMA==,12,j_94879,10,Terminated,562287,562312,25,100,0.1
task_LTg0MTUwNTA5Mjg4MDkwNjIzMA==,23,j_836886,10,Terminated,303096,303230,134,100,0.1
task_LTg0MTUwNTA5Mjg4MDkwNjIzMA==,13,j_154960,10,Terminated,562322,562344,22,100,0.1
task_LTg0MTUwNTA5Mjg4MDkwNjIzMA==,22,j_368842,10,Terminated,130329,130353,24,100,0.1
task_LTg0MTUwNTA5Mjg4MDkwNjIzMA==,13,j_258881,10,Terminated,303141,303165,24,100,0.1
task_LTg0MTUwNTA5Mjg4MDkwNjIzMA==,70,j_759242,10,Terminated,130346,130378,32,100,0.1
task_ODg3NTU4NTE3NDcxODA4NjA5Ng==,40,j_888101,3,Terminated,303175,303218,43,100,0.39
task_LTg0MTUwNTA5Mjg4MDkwNjIzMA==,13,j_281510,10,Terminated,130388,130413,25,100,0.1
task_LTg0MTUwNTA5Mjg4MDkwNjIzMA==,34,j_332751,10,Terminated,562393,562430,37,100,0.1
task_LTg0MTUwNTA5Mjg4MDkwNjIzMA==,10,j_292311,10,Terminated,130399,130590,191,75,0.1
task_LTg0MTUwNTA5Mjg4MDkwNjIzMA==,16,j_682583,10,Terminated,130408,130590,182,75,0.1
task_LTg0MTUwNTA5Mjg4MDkwNjIzMA==,56,j_172653,10,Terminated,562429,562463,34,100,0.1
task_LTg0MTUwNTA5Mjg4MDkwNjIzMA==,25,j_388654,10,Terminated,476052,476075,23,100,0.1
task_LTg5MTI5MTc1ODQzMjE2MTczMTk=,41,j_119120,3,Terminated,627284,627392,108,100,0.79
task_LTg0MTUwNTA5Mjg4MDkwNjIzMA==,13,j_841272,10,Terminated,238504,238525,21,100,0.1
task_LTg0MTUwNTA5Mjg4MDkwNjIzMA==,43,j_40657,10,Terminated,476104,476170,66,100,0.1
task_LTg0MTUwNTA5Mjg4MDkwNjIzMA==,14,j_315782,10,Terminated,130517,130539,22,100,0.1
task_LTg0MTUwNTA5Mjg4MDkwNjIzMA==,41,j_426421,10,Terminated,562528,562571,43,100,0.1
task_LTg0MTUwNTA5Mjg4MDkwNjIzMA==,98,j_613030,10,Terminated,130531,130564,33,100,0.1
task_LTc1MTA1ODYwNDQ2OTU2MzYwMzA=,21,j_687281,12,Terminated,195346,195373,27,100,0.39
task_MzQwMDQzNjY0MzkwNzU2ODYyMg==,36,j_437869,12,Terminated,108960,109067,107,100,0.79
task_LTI0MjU2NDM0NTE3NDI0MzkwNjE=,36,j_437869,12,Terminated,108960,109160,200,100,0.79
task_LTg0MTUwNTA5Mjg4MDkwNjIzMA==,72,j_376608,10,Terminated,130564,130590,26,100,0.1
task_LTg0MTUwNTA5Mjg4MDkwNjIzMA==,58,j_290785,10,Terminated,562573,562604,31,100,0.1
task_LTg0MTUwNTA5Mjg4MDkwNjIzMA==,82,j_505381,10,Terminated,303376,303420,44,100,0.1
task_LTg0MTUwNTA5Mjg4MDkwNjIzMA==,63,j_816509,10,Terminated,562604,562637,33,100,0.1
task_LTg0MTUwNTA5Mjg4MDkwNjIzMA==,38,j_322719,10,Terminated,217006,217068,62,100,0.1
task_LTg0MTUwNTA5Mjg4MDkwNjIzMA==,12,j_230119,10,Terminated,562611,562636,25,100,0.1
task_LTg0MTUwNTA5Mjg4MDkwNjIzMA==,38,j_656230,10,Terminated,130612,130786,174,75,0.1
task_LTg0MTUwNTA5Mjg4MDkwNjIzMA==,16,j_377661,10,Terminated,649017,649042,25,100,0.1
task_LTg5MTI5MTc1ODQzMjE2MTczMTk=,42,j_436628,3,Terminated,217020,217114,94,100,0.79
task_LTg0MTUwNTA5Mjg4MDkwNjIzMA==,35,j_735815,10,Terminated,562632,562653,21,100,0.1
task_LTg0MTUwNTA5Mjg4MDkwNjIzMA==,44,j_99568,10,Terminated,562640,562684,44,100,0.1
task_LTg0MTUwNTA5Mjg4MDkwNjIzMA==,15,j_146180,10,Terminated,649053,649074,21,100,0.1
task_LTg0MTUwNTA5Mjg4MDkwNjIzMA==,13,j_228383,10,Terminated,130658,130683,25,100,0.1
task_LTg0MTUwNTA5Mjg4MDkwNjIzMA==,30,j_361554,10,Terminated,562666,562696,30,100,0.1
task_LTg0MTUwNTA5Mjg4MDkwNjIzMA==,44,j_168091,10,Terminated,562684,562724,40,100,0.1
task_LTg0MTUwNTA5Mjg4MDkwNjIzMA==,27,j_765316,10,Terminated,303502,303527,25,100,0.1
task_LTg0MTUwNTA5Mjg4MDkwNjIzMA==,39,j_508283,10,Terminated,562705,562735,30,100,0.1
task_LTg0MTUwNTA5Mjg4MDkwNjIzMA==,49,j_589323,10,Terminated,562719,562752,33,100,0.1
task_LTg0MTUwNTA5Mjg4MDkwNjIzMA==,26,j_224702,10,Terminated,476320,476344,24,100,0.1
task_LTg0MTUwNTA5Mjg4MDkwNjIzMA==,49,j_404204,10,Terminated,562725,562754,29,100,0.1
task_LTg0MTUwNTA5Mjg4MDkwNjIzMA==,15,j_169991,10,Terminated,562726,562767,41,100,0.1
task_LTg0MTUwNTA5Mjg4MDkwNjIzMA==,10,j_97611,10,Terminated,649133,649160,27,100,0.1
task_MzQwMDQzNjY0MzkwNzU2ODYyMg==,65,j_359037,3,Terminated,281934,282002,68,100,0.39
task_ODYzMjgxNTM3NDQ2NzUwMjQxMg==,40,j_545541,8,Terminated,346735,346793,58,100,0.59
task_ODYzMjgxNTM3NDQ2NzUwMjQxMg==,40,j_696041,8,Terminated,346735,346765,30,100,0.59
task_LTg0MTUwNTA5Mjg4MDkwNjIzMA==,13,j_513859,10,Terminated,238761,238781,20,100,0.1
task_LTg0MTUwNTA5Mjg4MDkwNjIzMA==,12,j_735807,10,Terminated,562761,562781,20,100,0.1
task_LTg0MTUwNTA5Mjg4MDkwNjIzMA==,23,j_769290,10,Terminated,476375,476411,36,100,0.1
task_LTg0MTUwNTA5Mjg4MDkwNjIzMA==,98,j_99727,10,Terminated,130776,130805,29,100,0.1
task_LTg0MTUwNTA5Mjg4MDkwNjIzMA==,15,j_158655,10,Terminated,649179,649199,20,100,0.1
task_LTg0MTUwNTA5Mjg4MDkwNjIzMA==,14,j_440796,10,Terminated,130796,130820,24,100,0.1
task_ODg3NTU4NTE3NDcxODA4NjA5Ng==,40,j_513600,3,Terminated,627607,627662,55,100,0.39
task_LTg0MTUwNTA5Mjg4MDkwNjIzMA==,77,j_735523,10,Terminated,130842,131036,194,75,0.1
task_LTg0MTUwNTA5Mjg4MDkwNjIzMA==,21,j_364221,10,Terminated,670848,670875,27,100,0.1
task_LTg0MTUwNTA5Mjg4MDkwNjIzMA==,17,j_608549,10,Terminated,130851,130881,30,100,0.1
task_LTg0MTUwNTA5Mjg4MDkwNjIzMA==,61,j_296945,10,Terminated,303652,303751,99,100,0.1
task_MzQwMDQzNjY0MzkwNzU2ODYyMg==,12,j_572250,3,Terminated,109252,109315,63,100,0.39
task_LTg0MTUwNTA5Mjg4MDkwNjIzMA==,52,j_593365,10,Terminated,562871,562897,26,100,0.1
task_LTg0MTUwNTA5Mjg4MDkwNjIzMA==,58,j_251611,10,Terminated,562871,562901,30,100,0.1
task_LTg0MTUwNTA5Mjg4MDkwNjIzMA==,15,j_402336,10,Terminated,649284,649306,22,100,0.1
task_LTg0MTUwNTA5Mjg4MDkwNjIzMA==,21,j_355370,10,Terminated,649296,649317,21,100,0.1
task_MzQwMDQzNjY0MzkwNzU2ODYyMg==,20,j_418999,3,Terminated,346906,346937,31,100,0.2
task_LTg0MTUwNTA5Mjg4MDkwNjIzMA==,14,j_129782,10,Terminated,130917,130946,29,100,0.1
task_LTg0MTUwNTA5Mjg4MDkwNjIzMA==,31,j_176213,10,Terminated,498132,498152,20,100,0.1
task_LTg0MTUwNTA5Mjg4MDkwNjIzMA==,10,j_848256,10,Terminated,584544,584575,31,100,0.1
task_LTg0MTUwNTA5Mjg4MDkwNjIzMA==,21,j_843763,10,Terminated,562963,562988,25,100,0.1
task_LTg0MTUwNTA5Mjg4MDkwNjIzMA==,22,j_125314,10,Terminated,130968,131137,169,75,0.1
task_LTg0MTUwNTA5Mjg4MDkwNjIzMA==,20,j_842662,10,Terminated,562970,563025,55,100,0.1
task_LTg0MTUwNTA5Mjg4MDkwNjIzMA==,46,j_426155,10,Terminated,562986,563010,24,100,0.1
task_LTg0MTUwNTA5Mjg4MDkwNjIzMA==,14,j_414277,10,Terminated,649390,649416,26,100,0.1
task_MzQwMDQzNjY0MzkwNzU2ODYyMg==,60,j_459918,12,Terminated,109408,109458,50,100,0.39
task_MzQwMDQzNjY0MzkwNzU2ODYyMg==,39,j_653810,3,Terminated,584611,584678,67,100,0.19
task_MzQwMDQzNjY0MzkwNzU2ODYyMg==,35,j_145091,3,Terminated,584637,584666,29,100,0.19
task_LTg0MTUwNTA5Mjg4MDkwNjIzMA==,27,j_169630,10,Terminated,498255,498276,21,100,0.1
task_LTg0MTUwNTA5Mjg4MDkwNjIzMA==,40,j_41724,10,Terminated,649460,649486,26,100,0.1
task_LTg0MTUwNTA5Mjg4MDkwNjIzMA==,14,j_96284,10,Terminated,303903,303924,21,100,0.1
task_LTg0MTUwNTA5Mjg4MDkwNjIzMA==,31,j_151762,10,Terminated,498358,498378,20,100,0.1
task_LTg0MTUwNTA5Mjg4MDkwNjIzMA==,30,j_441170,10,Terminated,563163,563213,50,100,0.1
task_LTg0MTUwNTA5Mjg4MDkwNjIzMA==,76,j_737362,10,Terminated,649573,649599,26,100,0.1
task_MzQwMDQzNjY0MzkwNzU2ODYyMg==,36,j_771811,12,Terminated,195973,196133,160,100,0.79
task_LTI0MjU2NDM0NTE3NDI0MzkwNjE=,36,j_771811,12,Terminated,195974,196149,175,100,0.79
task_MzQwMDQzNjY0MzkwNzU2ODYyMg==,10,j_449135,3,Terminated,174374,174489,115,100,0.39
task_LTg0MTUwNTA5Mjg4MDkwNjIzMA==,77,j_412243,10,Terminated,131182,131218,36,100,0.1
task_LTg0MTUwNTA5Mjg4MDkwNjIzMA==,35,j_126094,10,Terminated,563201,563240,39,100,0.1
task_ODg3NTU4NTE3NDcxODA4NjA5Ng==,40,j_23657,3,Terminated,455220,455353,133,100,0.39
task_LTg0MTUwNTA5Mjg4MDkwNjIzMA==,17,j_193000,10,Terminated,671236,671262,26,100,0.1
task_OTg1NjA1OTIxMzA4ODkxNg==,28,j_472437,8,Terminated,174438,174462,24,100,0.59
task_NzQ3MjEzNzg0MzE5NDE5NzM1Mg==,24,j_256061,3,Terminated,368864,368979,115,100,1.53
task_NzQ3MjEzNzg0MzE5NDE5NzM1Mg==,11,j_746842,3,Terminated,628072,628269,197,100,1.53
task_LTg0MTUwNTA5Mjg4MDkwNjIzMA==,68,j_349914,10,Terminated,131296,131340,44,100,0.1
task_LTg0MTUwNTA5Mjg4MDkwNjIzMA==,12,j_617035,10,Terminated,584900,584924,24,100,0.1
task_ODg3NTU4NTE3NDcxODA4NjA5Ng==,40,j_591617,3,Terminated,541740,541781,41,100,0.39
task_LTg0MTUwNTA5Mjg4MDkwNjIzMA==,24,j_206639,10,Terminated,131373,131410,37,100,0.1
task_LTg0MTUwNTA5Mjg4MDkwNjIzMA==,30,j_448663,10,Terminated,217774,217806,32,100,0.1
task_LTg0MTUwNTA5Mjg4MDkwNjIzMA==,24,j_779912,10,Terminated,131391,131435,44,100,0.1
task_OTg1NjA1OTIxMzA4ODkxNg==,49,j_789026,8,Terminated,649829,649851,22,100,0.59
task_ODYzMjgxNTM3NDQ2NzUwMjQxMg==,17,j_789026,8,Terminated,649829,649877,48,100,0.59
task_LTg0MTUwNTA5Mjg4MDkwNjIzMA==,30,j_620449,10,Terminated,498631,498655,24,100,0.1
task_OTg1NjA1OTIxMzA4ODkxNg==,25,j_389437,8,Terminated,628244,628355,111,100,0.59
task_LTg0MTUwNTA5Mjg4MDkwNjIzMA==,86,j_452552,10,Terminated,131446,131470,24,100,0.1
task_OTg1NjA1OTIxMzA4ODkxNg==,49,j_153598,8,Terminated,217848,217869,21,100,0.59
task_ODYzMjgxNTM3NDQ2NzUwMjQxMg==,17,j_153598,8,Terminated,217848,217891,43,100,0.59
task_LTg0MTUwNTA5Mjg4MDkwNjIzMA==,23,j_713824,10,Terminated,671455,671498,43,100,0.1
task_OTg1NjA1OTIxMzA4ODkxNg==,25,j_366897,8,Terminated,369065,369139,74,100,0.59
task_LTg0MTUwNTA5Mjg4MDkwNjIzMA==,36,j_421497,10,Terminated,304267,304297,30,100,0.1
task_LTg0MTUwNTA5Mjg4MDkwNjIzMA==,61,j_889792,10,Terminated,131474,131499,25,100,0.1
task_OTg1NjA1OTIxMzA4ODkxNg==,25,j_625043,8,Terminated,282681,282727,46,100,0.59
task_LTg0MTUwNTA5Mjg4MDkwNjIzMA==,12,j_319456,10,Terminated,131492,131525,33,100,0.1
task_LTg0MTUwNTA5Mjg4MDkwNjIzMA==,32,j_74651,10,Terminated,649901,649932,31,100,0.1
task_LTg0MTUwNTA5Mjg4MDkwNjIzMA==,49,j_759511,10,Terminated,563513,563540,27,100,0.1
task_LTg0MTUwNTA5Mjg4MDkwNjIzMA==,29,j_758524,10,Terminated,563522,563548,26,100,0.1
task_MzQwMDQzNjY0MzkwNzU2ODYyMg==,13,j_149362,3,Terminated,131528,131558,30,100,0.32
task_LTg0MTUwNTA5Mjg4MDkwNjIzMA==,10,j_752920,10,Terminated,131535,131557,22,100,0.1
task_MzQwMDQzNjY0MzkwNzU2ODYyMg==,15,j_214309,3,Terminated,131539,131567,28,100,0.32
task_LTg0MTUwNTA5Mjg4MDkwNjIzMA==,31,j_116075,10,Terminated,563564,563587,23,100,0.1
task_LTg0MTUwNTA5Mjg4MDkwNjIzMA==,55,j_356204,10,Terminated,563568,563594,26,100,0.1
task_LTg0MTUwNTA5Mjg4MDkwNjIzMA==,36,j_451871,10,Terminated,563579,563607,28,100,0.1
task_LTg0MTUwNTA5Mjg4MDkwNjIzMA==,30,j_282630,10,Terminated,498810,498830,20,100,0.1
task_LTg0MTUwNTA5Mjg4MDkwNjIzMA==,13,j_851813,10,Terminated,239613,239635,22,100,0.1
task_LTg0MTUwNTA5Mjg4MDkwNjIzMA==,67,j_810751,10,Terminated,131640,131665,25,100,0.1
task_LTg0MTUwNTA5Mjg4MDkwNjIzMA==,26,j_423986,10,Terminated,131640,131824,184,75,0.1
task_LTg0MTUwNTA5Mjg4MDkwNjIzMA==,12,j_690960,10,Terminated,218055,218085,30,100,0.1
task_LTg0MTUwNTA5Mjg4MDkwNjIzMA==,53,j_697824,10,Terminated,131658,131684,26,100,0.1
task_MjA0NDk5ODc0NDc1NzAwMzc3Mw==,20,j_54351,3,Terminated,261279,261323,44,100,0.2
task_LTg0MTUwNTA5Mjg4MDkwNjIzMA==,14,j_348197,10,Terminated,563683,563703,20,100,0.1
task_LTg0MTUwNTA5Mjg4MDkwNjIzMA==,12,j_506819,10,Terminated,563687,563707,20,100,0.1
task_LTg0MTUwNTA5Mjg4MDkwNjIzMA==,52,j_253443,10,Terminated,650100,650126,26,100,0.1
task_LTg0MTUwNTA5Mjg4MDkwNjIzMA==,13,j_614985,10,Terminated,239718,239745,27,100,0.1
task_NzQ3MjEzNzg0MzE5NDE5NzM1Mg==,22,j_279620,3,Terminated,477330,477366,36,100,1.53
task_LTg0MTUwNTA5Mjg4MDkwNjIzMA==,33,j_17099,10,Terminated,218164,218187,23,100,0.1
task_LTg0MTUwNTA5Mjg4MDkwNjIzMA==,39,j_276402,10,Terminated,304586,304619,33,100,0.1
task_LTg0MTUwNTA5Mjg4MDkwNjIzMA==,12,j_82695,10,Terminated,304627,304656,29,100,0.1
task_LTg0MTUwNTA5Mjg4MDkwNjIzMA==,30,j_493891,10,Terminated,218260,218292,32,100,0.1
task_LTg0MTUwNTA5Mjg4MDkwNjIzMA==,10,j_123636,10,Terminated,131865,131889,24,100,0.1
task_LTg0MTUwNTA5Mjg4MDkwNjIzMA==,38,j_349054,10,Terminated,563868,563891,23,100,0.1
task_LTg0MTUwNTA5Mjg4MDkwNjIzMA==,50,j_431353,10,Terminated,131869,131895,26,100,0.1
task_LTg0MTUwNTA5Mjg4MDkwNjIzMA==,20,j_866177,10,Terminated,563881,563907,26,100,0.1
task_LTg0MTUwNTA5Mjg4MDkwNjIzMA==,13,j_55925,10,Terminated,239885,239905,20,100,0.1
task_LTg0MTUwNTA5Mjg4MDkwNjIzMA==,38,j_479816,10,Terminated,218306,218345,39,100,0.1
task_LTg0MTUwNTA5Mjg4MDkwNjIzMA==,25,j_274646,10,Terminated,563909,563933,24,100,0.1
task_LTg0MTUwNTA5Mjg4MDkwNjIzMA==,36,j_788167,10,Terminated,563925,563967,42,100,0.1
task_LTg0MTUwNTA5Mjg4MDkwNjIzMA==,29,j_608600,10,Terminated,499159,499180,21,100,0.1
task_LTg0MTUwNTA5Mjg4MDkwNjIzMA==,29,j_21072,10,Terminated,499161,499182,21,100,0.1
task_LTg0MTUwNTA5Mjg4MDkwNjIzMA==,29,j_482075,10,Terminated,563961,563985,24,100,0.1
task_LTg0MTUwNTA5Mjg4MDkwNjIzMA==,10,j_760024,10,Terminated,131978,132011,33,100,0.1
task_LTg0MTUwNTA5Mjg4MDkwNjIzMA==,41,j_807388,10,Terminated,304782,304807,25,100,0.1
task_LTg0MTUwNTA5Mjg4MDkwNjIzMA==,49,j_849416,10,Terminated,564013,564036,23,100,0.1
task_LTg0MTUwNTA5Mjg4MDkwNjIzMA==,25,j_872696,10,Terminated,218421,218447,26,100,0.1
task_LTg0MTUwNTA5Mjg4MDkwNjIzMA==,20,j_68654,10,Terminated,499230,499254,24,100,0.1
task_LTg0MTUwNTA5Mjg4MDkwNjIzMA==,31,j_360855,10,Terminated,499252,499272,20,100,0.1
task_LTg0MTUwNTA5Mjg4MDkwNjIzMA==,39,j_891369,10,Terminated,304855,304897,42,100,0.1
task_LTg0MTUwNTA5Mjg4MDkwNjIzMA==,63,j_721834,10,Terminated,132066,132097,31,100,0.1
task_LTg0MTUwNTA5Mjg4MDkwNjIzMA==,43,j_595964,10,Terminated,564076,564103,27,100,0.1
task_LTg0MTUwNTA5Mjg4MDkwNjIzMA==,18,j_93671,10,Terminated,218485,218510,25,100,0.1
task_LTg0MTUwNTA5Mjg4MDkwNjIzMA==,20,j_529201,10,Terminated,499291,499317,26,100,0.1
task_LTg0MTUwNTA5Mjg4MDkwNjIzMA==,14,j_550008,10,Terminated,153728,153752,24,100,0.1
task_LTg0MTUwNTA5Mjg4MDkwNjIzMA==,11,j_275237,10,Terminated,564148,564188,40,100,0.1
task_ODg3NTU4NTE3NDcxODA4NjA5Ng==,55,j_272331,3,Terminated,196957,197112,155,100,0.39
task_LTg0MTUwNTA5Mjg4MDkwNjIzMA==,31,j_713982,10,Terminated,218557,218581,24,100,0.1
task_LTg0MTUwNTA5Mjg4MDkwNjIzMA==,39,j_685658,10,Terminated,650564,650591,27,100,0.1
task_LTg0MTUwNTA5Mjg4MDkwNjIzMA==,30,j_702650,10,Terminated,564165,564189,24,100,0.1
task_LTg0MTUwNTA5Mjg4MDkwNjIzMA==,30,j_239309,10,Terminated,564166,564221,55,100,0.1
task_LTg0MTUwNTA5Mjg4MDkwNjIzMA==,11,j_656562,10,Terminated,305005,305028,23,100,0.1
task_LTg0MTUwNTA5Mjg4MDkwNjIzMA==,34,j_692070,10,Terminated,218607,218630,23,100,0.1
task_LTg0MTUwNTA5Mjg4MDkwNjIzMA==,10,j_300967,10,Terminated,132213,132275,62,100,0.1
task_LTg0MTUwNTA5Mjg4MDkwNjIzMA==,61,j_614715,10,Terminated,132223,132298,75,100,0.1
task_LTg0MTUwNTA5Mjg4MDkwNjIzMA==,18,j_274113,10,Terminated,218635,218662,27,100,0.1
task_LTg0MTUwNTA5Mjg4MDkwNjIzMA==,11,j_65605,10,Terminated,650638,650662,24,100,0.1
task_LTg0MTUwNTA5Mjg4MDkwNjIzMA==,33,j_906487,10,Terminated,564249,564273,24,100,0.1
task_LTg0MTUwNTA5Mjg4MDkwNjIzMA==,29,j_126680,10,Terminated,564268,564295,27,100,0.1
task_LTg0MTUwNTA5Mjg4MDkwNjIzMA==,55,j_115553,10,Terminated,132270,132312,42,100,0.1
task_LTg0MTUwNTA5Mjg4MDkwNjIzMA==,29,j_24891,10,Terminated,564281,564306,25,100,0.1
task_LTg0MTUwNTA5Mjg4MDkwNjIzMA==,12,j_725519,10,Terminated,650681,650701,20,100,0.1
task_LTg0MTUwNTA5Mjg4MDkwNjIzMA==,94,j_290764,10,Terminated,218684,218710,26,100,0.1
task_LTg0MTUwNTA5Mjg4MDkwNjIzMA==,15,j_530224,10,Terminated,218695,218725,30,100,0.1
task_LTg0MTUwNTA5Mjg4MDkwNjIzMA==,37,j_159782,10,Terminated,564301,564330,29,100,0.1
task_LTg0MTUwNTA5Mjg4MDkwNjIzMA==,23,j_312132,10,Terminated,564303,564334,31,100,0.1
task_LTg0MTUwNTA5Mjg4MDkwNjIzMA==,12,j_280371,10,Terminated,650715,650736,21,100,0.1
task_LTg0MTUwNTA5Mjg4MDkwNjIzMA==,31,j_752567,8,Terminated,132338,132379,41,100,0.1
task_LTg0MTUwNTA5Mjg4MDkwNjIzMA==,28,j_869760,10,Terminated,132338,132384,46,100,0.1
task_LTg0MTUwNTA5Mjg4MDkwNjIzMA==,39,j_821041,10,Terminated,305150,305176,26,100,0.1
task_LTg0MTUwNTA5Mjg4MDkwNjIzMA==,18,j_93271,10,Terminated,218762,218787,25,100,0.1
task_LTg0MTUwNTA5Mjg4MDkwNjIzMA==,29,j_389651,10,Terminated,218774,218834,60,100,0.1
task_LTg0MTUwNTA5Mjg4MDkwNjIzMA==,15,j_416380,10,Terminated,153986,154008,22,100,0.1
task_LTg0MTUwNTA5Mjg4MDkwNjIzMA==,11,j_299326,10,Terminated,650793,650816,23,100,0.1
task_OTg1NjA1OTIxMzA4ODkxNg==,12,j_723039,8,Terminated,564418,564470,52,100,0.59
task_LTg0MTUwNTA5Mjg4MDkwNjIzMA==,14,j_387894,10,Terminated,564418,564441,23,100,0.1
task_LTg0MTUwNTA5Mjg4MDkwNjIzMA==,22,j_379529,10,Terminated,564418,564439,21,100,0.1
task_LTg0MTUwNTA5Mjg4MDkwNjIzMA==,12,j_471918,10,Terminated,650839,650859,20,100,0.1
task_LTg0MTUwNTA5Mjg4MDkwNjIzMA==,37,j_87628,10,Terminated,218843,218885,42,100,0.1
task_LTg0MTUwNTA5Mjg4MDkwNjIzMA==,19,j_27732,10,Terminated,218847,218873,26,100,0.1
task_LTg0MTUwNTA5Mjg4MDkwNjIzMA==,43,j_321128,10,Terminated,564450,564471,21,100,0.1
task_LTg0MTUwNTA5Mjg4MDkwNjIzMA==,18,j_509017,10,Terminated,218869,218913,44,100,0.1
task_MzQwMDQzNjY0MzkwNzU2ODYyMg==,22,j_427290,3,Terminated,283697,283736,39,100,0.39
task_LTI0MjU2NDM0NTE3NDI0MzkwNjE=,22,j_427290,3,Terminated,283698,283835,137,100,0.39
task_LTg0MTUwNTA5Mjg4MDkwNjIzMA==,14,j_375811,10,Terminated,305300,305326,26,100,0.1
task_MzQwMDQzNjY0MzkwNzU2ODYyMg==,15,j_731082,3,Terminated,305302,305367,65,100,0.32
task_LTg0MTUwNTA5Mjg4MDkwNjIzMA==,18,j_878015,10,Terminated,218934,218957,23,100,0.1
task_LTg0MTUwNTA5Mjg4MDkwNjIzMA==,10,j_783284,10,Terminated,132542,132564,22,100,0.1
task_LTg0MTUwNTA5Mjg4MDkwNjIzMA==,12,j_668334,10,Terminated,650958,650995,37,100,0.1
task_LTg0MTUwNTA5Mjg4MDkwNjIzMA==,10,j_243991,10,Terminated,305363,305386,23,100,0.1
task_LTg0MTUwNTA5Mjg4MDkwNjIzMA==,18,j_331997,10,Terminated,305366,305403,37,100,0.1
task_NzQ3MjEzNzg0MzE5NDE5NzM1Mg==,14,j_736042,3,Terminated,110979,111092,113,100,1.53
task_LTg0MTUwNTA5Mjg4MDkwNjIzMA==,94,j_713741,10,Terminated,219002,219029,27,100,0.1
task_NzQ3MjEzNzg0MzE5NDE5NzM1Mg==,22,j_797757,3,Terminated,564625,564697,72,100,1.53
task_LTg0MTUwNTA5Mjg4MDkwNjIzMA==,18,j_81598,10,Terminated,219046,219089,43,100,0.1
task_LTg0MTUwNTA5Mjg4MDkwNjIzMA==,21,j_516290,10,Terminated,499850,499881,31,100,0.1
task_LTg0MTUwNTA5Mjg4MDkwNjIzMA==,28,j_264005,10,Terminated,132652,132731,79,100,0.1
task_MzQwMDQzNjY0MzkwNzU2ODYyMg==,10,j_112813,3,Terminated,219056,219113,57,100,0.32
task_MzQwMDQzNjY0MzkwNzU2ODYyMg==,12,j_50135,3,Terminated,456657,456739,82,100,0.39
task_ODg3NTU4NTE3NDcxODA4NjA5Ng==,40,j_173608,3,Terminated,629485,629564,79,100,0.39
task_LTg0MTUwNTA5Mjg4MDkwNjIzMA==,12,j_530986,10,Terminated,651089,651111,22,100,0.1
task_LTg0MTUwNTA5Mjg4MDkwNjIzMA==,31,j_726408,10,Terminated,478317,478340,23,100,0.1
task_LTg0MTUwNTA5Mjg4MDkwNjIzMA==,15,j_114028,10,Terminated,154321,154341,20,100,0.1
task_LTg0MTUwNTA5Mjg4MDkwNjIzMA==,12,j_819121,10,Terminated,564727,564757,30,100,0.1
task_LTg0MTUwNTA5Mjg4MDkwNjIzMA==,24,j_663436,10,Terminated,564764,564787,23,100,0.1
task_LTg0MTUwNTA5Mjg4MDkwNjIzMA==,14,j_304915,10,Terminated,651175,651199,24,100,0.1
task_LTg0MTUwNTA5Mjg4MDkwNjIzMA==,10,j_27121,10,Terminated,305631,305665,34,100,0.1
task_LTg0MTUwNTA5Mjg4MDkwNjIzMA==,30,j_218277,10,Terminated,564856,564881,25,100,0.1
task_LTg0MTUwNTA5Mjg4MDkwNjIzMA==,12,j_732812,10,Terminated,240890,240912,22,100,0.1
task_LTg0MTUwNTA5Mjg4MDkwNjIzMA==,39,j_181338,10,Terminated,132902,132927,25,100,0.1
task_LTg0MTUwNTA5Mjg4MDkwNjIzMA==,29,j_117345,10,Terminated,132921,132944,23,100,0.1
task_LTg0MTUwNTA5Mjg4MDkwNjIzMA==,21,j_476394,10,Terminated,305730,305754,24,100,0.1
task_LTg0MTUwNTA5Mjg4MDkwNjIzMA==,22,j_87086,10,Terminated,219358,219398,40,100,0.1
task_LTg0MTUwNTA5Mjg4MDkwNjIzMA==,11,j_193349,10,Terminated,651359,651386,27,100,0.1
task_LTg0MTUwNTA5Mjg4MDkwNjIzMA==,90,j_713032,10,Terminated,219362,219392,30,100,0.1
task_LTg0MTUwNTA5Mjg4MDkwNjIzMA==,14,j_438091,10,Terminated,305796,305819,23,100,0.1
task_LTg0MTUwNTA5Mjg4MDkwNjIzMA==,19,j_42271,10,Terminated,305844,305878,34,100,0.1
task_LTg0MTUwNTA5Mjg4MDkwNjIzMA==,49,j_637993,10,Terminated,133044,133072,28,100,0.1
task_LTg0MTUwNTA5Mjg4MDkwNjIzMA==,27,j_351874,10,Terminated,651445,651468,23,100,0.1
task_LTg0MTUwNTA5Mjg4MDkwNjIzMA==,19,j_589662,10,Terminated,219485,219550,65,100,0.1
task_LTI0MjU2NDM0NTE3NDI0MzkwNjE=,18,j_418677,3,Terminated,262709,262746,37,100,0.39
task_LTg0MTUwNTA5Mjg4MDkwNjIzMA==,20,j_460057,8,Terminated,370709,370730,21,100,0.1
task_LTg0MTUwNTA5Mjg4MDkwNjIzMA==,33,j_369391,10,Terminated,565109,565129,20,100,0.1
task_LTg0MTUwNTA5Mjg4MDkwNjIzMA==,16,j_300980,10,Terminated,154714,154736,22,100,0.1
task_LTg0MTUwNTA5Mjg4MDkwNjIzMA==,26,j_567896,10,Terminated,219542,219583,41,100,0.1
task_LTg0MTUwNTA5Mjg4MDkwNjIzMA==,46,j_83063,10,Terminated,651549,651574,25,100,0.1
task_LTg0MTUwNTA5Mjg4MDkwNjIzMA==,10,j_455451,10,Terminated,478766,478796,30,100,0.1
task_LTg0MTUwNTA5Mjg4MDkwNjIzMA==,29,j_543466,10,Terminated,305987,306010,23,100,0.1
task_OTg1NjA1OTIxMzA4ODkxNg==,13,j_592093,8,Terminated,262792,262890,98,100,0.78
task_LTI0MjU2NDM0NTE3NDI0MzkwNjE=,18,j_339824,3,Terminated,176393,176430,37,100,0.39
task_LTg0MTUwNTA5Mjg4MDkwNjIzMA==,21,j_670351,10,Terminated,305998,306036,38,100,0.1
task_LTI0MjU2NDM0NTE3NDI0MzkwNjE=,10,j_53004,3,Terminated,198010,198152,142,100,0.39
task_LTg0MTUwNTA5Mjg4MDkwNjIzMA==,14,j_179325,10,Terminated,565210,565234,24,100,0.1
task_ODYzMjgxNTM3NDQ2NzUwMjQxMg==,27,j_176916,8,Terminated,154821,154864,43,100,0.59
task_OTg1NjA1OTIxMzA4ODkxNg==,75,j_176916,8,Terminated,154821,154842,21,100,0.59
task_ODYzMjgxNTM3NDQ2NzUwMjQxMg==,19,j_767805,8,Terminated,478822,478862,40,100,0.59
task_LTI0MjU2NDM0NTE3NDI0MzkwNjE=,15,j_233087,12,Terminated,198023,198126,103,100,0.39
task_ODYzMjgxNTM3NDQ2NzUwMjQxMg==,27,j_364788,8,Terminated,241224,241245,21,100,0.59
task_OTg1NjA1OTIxMzA4ODkxNg==,27,j_381558,8,Terminated,198025,198069,44,100,0.59
task_ODYzMjgxNTM3NDQ2NzUwMjQxMg==,11,j_381558,8,Terminated,198025,198093,68,100,0.59
task_OTg1NjA1OTIxMzA4ODkxNg==,75,j_766539,8,Terminated,241226,241249,23,100,0.59
task_ODYzMjgxNTM3NDQ2NzUwMjQxMg==,27,j_766539,8,Terminated,241226,241272,46,100,0.59
task_ODYzMjgxNTM3NDQ2NzUwMjQxMg==,11,j_376547,8,Terminated,111627,111658,31,100,0.59
task_LTg0MTUwNTA5Mjg4MDkwNjIzMA==,30,j_334373,10,Terminated,565233,565260,27,100,0.1
task_ODYzMjgxNTM3NDQ2NzUwMjQxMg==,11,j_283551,8,Terminated,370835,370940,105,100,0.59
task_OTg1NjA1OTIxMzA4ODkxNg==,27,j_283551,8,Terminated,370835,370873,38,100,0.59
task_ODYzMjgxNTM3NDQ2NzUwMjQxMg==,11,j_69129,8,Terminated,630037,630103,66,100,0.59
task_LTg0MTUwNTA5Mjg4MDkwNjIzMA==,21,j_224717,10,Terminated,565237,565263,26,100,0.1
task_OTg1NjA1OTIxMzA4ODkxNg==,27,j_69129,8,Terminated,630037,630078,41,100,0.59
task_LTg0MTUwNTA5Mjg4MDkwNjIzMA==,15,j_276429,10,Terminated,154838,154861,23,100,0.1
task_ODYzMjgxNTM3NDQ2NzUwMjQxMg==,11,j_175758,8,Terminated,457245,457315,70,100,0.59
task_OTg1NjA1OTIxMzA4ODkxNg==,13,j_889177,8,Terminated,198049,198165,116,100,0.78
task_OTg1NjA1OTIxMzA4ODkxNg==,27,j_669538,8,Terminated,457257,457317,60,100,0.59
task_ODYzMjgxNTM3NDQ2NzUwMjQxMg==,11,j_669538,8,Terminated,457258,457343,85,100,0.59
task_LTg0MTUwNTA5Mjg4MDkwNjIzMA==,15,j_552330,10,Terminated,154864,154885,21,100,0.1
task_LTg0MTUwNTA5Mjg4MDkwNjIzMA==,22,j_876429,10,Terminated,478892,478916,24,100,0.1
task_LTg0MTUwNTA5Mjg4MDkwNjIzMA==,19,j_591618,10,Terminated,565295,565316,21,100,0.1
task_LTg0MTUwNTA5Mjg4MDkwNjIzMA==,47,j_448183,10,Terminated,306129,306150,21,100,0.1
task_LTg0MTUwNTA5Mjg4MDkwNjIzMA==,10,j_47990,10,Terminated,241343,241366,23,100,0.1
task_LTg0MTUwNTA5Mjg4MDkwNjIzMA==,55,j_340862,10,Terminated,133345,133491,146,75,0.1
task_LTE3Nzc5Mzc0NTEyODIyMTQwNTc=,44,j_456179,3,Terminated,435758,435810,52,100,0.39
task_Mjc5MzA3NTE4MTEyMDI2MTQ2OQ==,44,j_456179,3,Terminated,435758,435837,79,100,0.39
task_LTg0MTUwNTA5Mjg4MDkwNjIzMA==,11,j_342661,10,Terminated,241358,241381,23,100,0.1
task_MTY3NzU4MzIxMzMzNDg4OTMzOQ==,44,j_456179,3,Terminated,435758,435821,63,100,0.39
task_LTg0MTUwNTA5Mjg4MDkwNjIzMA==,22,j_799797,10,Terminated,306210,306231,21,100,0.1
task_LTg0MTUwNTA5Mjg4MDkwNjIzMA==,17,j_261561,10,Terminated,673417,673599,182,100,0.1
task_LTg0MTUwNTA5Mjg4MDkwNjIzMA==,11,j_124584,10,Terminated,565432,565452,20,100,0.1
task_Mjc5MzA3NTE4MTEyMDI2MTQ2OQ==,36,j_104583,3,Terminated,651848,651942,94,100,0.39
task_LTE3Nzc5Mzc0NTEyODIyMTQwNTc=,36,j_104583,3,Terminated,651848,651889,41,100,0.39
task_MTY3NzU4MzIxMzMzNDg4OTMzOQ==,36,j_104583,3,Terminated,651848,651913,65,100,0.39
task_LTI0MjU2NDM0NTE3NDI0MzkwNjE=,100,j_36780,3,Terminated,392669,392745,76,100,0.77
task_MzQwMDQzNjY0MzkwNzU2ODYyMg==,29,j_36780,3,Terminated,392669,392718,49,100,0.77
task_LTg0MTUwNTA5Mjg4MDkwNjIzMA==,57,j_377240,10,Terminated,651870,651890,20,100,0.1
task_LTg0MTUwNTA5Mjg4MDkwNjIzMA==,13,j_613159,10,Terminated,651872,651892,20,100,0.1
task_LTg0MTUwNTA5Mjg4MDkwNjIzMA==,14,j_360003,10,Terminated,241478,241501,23,100,0.1
task_LTg0MTUwNTA5Mjg4MDkwNjIzMA==,28,j_304604,10,Terminated,565497,565524,27,100,0.1
task_OTg1NjA1OTIxMzA4ODkxNg==,28,j_750388,8,Terminated,673515,673579,64,100,0.59
task_LTg0MTUwNTA5Mjg4MDkwNjIzMA==,20,j_279710,10,Terminated,673517,673537,20,100,0.1
task_LTg0MTUwNTA5Mjg4MDkwNjIzMA==,24,j_308625,10,Terminated,673518,673544,26,100,0.1
task_LTI0MjU2NDM0NTE3NDI0MzkwNjE=,20,j_312681,3,Terminated,176720,176757,37,100,0.39
task_LTg0MTUwNTA5Mjg4MDkwNjIzMA==,31,j_307837,10,Terminated,565521,565543,22,100,0.1
task_LTg0MTUwNTA5Mjg4MDkwNjIzMA==,20,j_56256,10,Terminated,479122,479150,28,100,0.1
task_LTI0MjU2NDM0NTE3NDI0MzkwNjE=,69,j_429721,3,Terminated,457533,457605,72,100,0.39
task_MzQwMDQzNjY0MzkwNzU2ODYyMg==,69,j_429721,3,Terminated,457533,457554,21,100,0.39
task_LTg0MTUwNTA5Mjg4MDkwNjIzMA==,23,j_60387,10,Terminated,500741,500761,20,100,0.1
task_LTg0MTUwNTA5Mjg4MDkwNjIzMA==,44,j_299754,10,Terminated,133554,133581,27,100,0.1
task_LTg0MTUwNTA5Mjg4MDkwNjIzMA==,70,j_874053,10,Terminated,219965,220031,66,100,0.1
task_LTg0MTUwNTA5Mjg4MDkwNjIzMA==,11,j_76898,8,Terminated,112018,112139,121,100,0.1
task_LTg0MTUwNTA5Mjg4MDkwNjIzMA==,20,j_786296,10,Terminated,500824,500844,20,100,0.1
task_LTg0MTUwNTA5Mjg4MDkwNjIzMA==,64,j_513306,10,Terminated,652025,652049,24,100,0.1
task_LTg0MTUwNTA5Mjg4MDkwNjIzMA==,18,j_155071,10,Terminated,652029,652072,43,100,0.1
task_LTI0MjU2NDM0NTE3NDI0MzkwNjE=,20,j_141630,3,Terminated,587266,587298,32,100,0.39
task_LTg0MTUwNTA5Mjg4MDkwNjIzMA==,67,j_176609,10,Terminated,652082,652109,27,100,0.1
task_LTg0MTUwNTA5Mjg4MDkwNjIzMA==,16,j_306991,10,Terminated,133684,133714,30,100,0.1
task_LTg0MTUwNTA5Mjg4MDkwNjIzMA==,28,j_575161,10,Terminated,565704,565724,20,100,0.1
task_LTg0MTUwNTA5Mjg4MDkwNjIzMA==,57,j_217250,10,Terminated,133708,133738,30,100,0.1
task_LTg0MTUwNTA5Mjg4MDkwNjIzMA==,19,j_332078,10,Terminated,652121,652146,25,100,0.1
task_LTg0MTUwNTA5Mjg4MDkwNjIzMA==,39,j_764465,10,Terminated,133740,133773,33,100,0.1
task_LTg0MTUwNTA5Mjg4MDkwNjIzMA==,17,j_618061,10,Terminated,673743,673777,34,100,0.1
task_LTg0MTUwNTA5Mjg4MDkwNjIzMA==,21,j_113285,10,Terminated,673746,673772,26,100,0.1
task_LTg0MTUwNTA5Mjg4MDkwNjIzMA==,20,j_882124,10,Terminated,220188,220215,27,100,0.1
task_LTg0MTUwNTA5Mjg4MDkwNjIzMA==,20,j_369222,10,Terminated,220208,220262,54,100,0.1
task_LTg0MTUwNTA5Mjg4MDkwNjIzMA==,45,j_472335,10,Terminated,133820,133842,22,100,0.1
task_LTg0MTUwNTA5Mjg4MDkwNjIzMA==,13,j_192854,10,Terminated,501040,501061,21,100,0.1
task_MzQwMDQzNjY0MzkwNzU2ODYyMg==,80,j_888929,3,Terminated,544261,544315,54,100,0.39
task_LTI0MjU2NDM0NTE3NDI0MzkwNjE=,80,j_888929,3,Terminated,544261,544363,102,100,0.39
task_MzQwMDQzNjY0MzkwNzU2ODYyMg==,83,j_449352,3,Terminated,544261,544296,35,100,0.39
task_LTI0MjU2NDM0NTE3NDI0MzkwNjE=,83,j_449352,3,Terminated,544261,544429,168,100,0.39
task_LTg0MTUwNTA5Mjg4MDkwNjIzMA==,19,j_689957,10,Terminated,220266,220294,28,100,0.1
task_LTI0MjU2NDM0NTE3NDI0MzkwNjE=,13,j_819955,12,Terminated,371474,371629,155,100,0.39
task_MzQwMDQzNjY0MzkwNzU2ODYyMg==,13,j_819955,12,Terminated,371475,371568,93,100,0.39
task_LTg0MTUwNTA5Mjg4MDkwNjIzMA==,18,j_271345,10,Terminated,479494,479522,28,100,0.1
task_LTg0MTUwNTA5Mjg4MDkwNjIzMA==,31,j_319854,10,Terminated,133903,133927,24,100,0.1
task_NzQ3MjEzNzg0MzE5NDE5NzM1Mg==,21,j_535590,3,Terminated,652313,652335,22,100,1.53
task_LTI0MjU2NDM0NTE3NDI0MzkwNjE=,23,j_146627,3,Terminated,630716,630799,83,100,0.39
task_LTg0MTUwNTA5Mjg4MDkwNjIzMA==,57,j_392535,10,Terminated,652341,652368,27,100,0.1
task_MzQwMDQzNjY0MzkwNzU2ODYyMg==,82,j_433876,3,Terminated,652354,652374,20,100,0.39
task_LTI0MjU2NDM0NTE3NDI0MzkwNjE=,82,j_433876,3,Terminated,652354,652518,164,100,0.39
task_LTg0MTUwNTA5Mjg4MDkwNjIzMA==,44,j_741039,10,Terminated,133976,133999,23,100,0.1
task_LTI0MjU2NDM0NTE3NDI0MzkwNjE=,83,j_457512,3,Terminated,457988,458049,61,100,0.39
task_LTI0MjU2NDM0NTE3NDI0MzkwNjE=,50,j_690142,3,Terminated,544392,544483,91,100,0.77
task_LTg0MTUwNTA5Mjg4MDkwNjIzMA==,29,j_802957,10,Terminated,133995,134028,33,100,0.1
task_LTg0MTUwNTA5Mjg4MDkwNjIzMA==,23,j_537,10,Terminated,220433,220485,52,100,0.1
task_LTg0MTUwNTA5Mjg4MDkwNjIzMA==,47,j_490512,10,Terminated,652444,652484,40,100,0.1
task_LTg0MTUwNTA5Mjg4MDkwNjIzMA==,29,j_849616,10,Terminated,501255,501280,25,100,0.1
task_LTg0MTUwNTA5Mjg4MDkwNjIzMA==,50,j_126957,10,Terminated,306863,306895,32,100,0.1
task_LTI0MjU2NDM0NTE3NDI0MzkwNjE=,23,j_32296,3,Terminated,544474,544510,36,100,0.39
task_LTg0MTUwNTA5Mjg4MDkwNjIzMA==,18,j_907499,10,Terminated,479678,479715,37,100,0.1
task_LTg0MTUwNTA5Mjg4MDkwNjIzMA==,11,j_71798,10,Terminated,306881,306928,47,100,0.1
task_LTg0MTUwNTA5Mjg4MDkwNjIzMA==,16,j_646316,10,Terminated,155686,155710,24,100,0.1
task_LTg5MTI5MTc1ODQzMjE2MTczMTk=,41,j_630381,3,Terminated,285311,285511,200,100,0.79
task_LTg0MTUwNTA5Mjg4MDkwNjIzMA==,48,j_766650,10,Terminated,306914,306949,35,100,0.1
task_LTg0MTUwNTA5Mjg4MDkwNjIzMA==,19,j_212244,10,Terminated,479726,479765,39,100,0.1
task_LTg5MTI5MTc1ODQzMjE2MTczMTk=,44,j_865207,3,Terminated,674126,674281,155,100,0.79
task_LTg0MTUwNTA5Mjg4MDkwNjIzMA==,11,j_619930,10,Terminated,306963,306990,27,100,0.1
task_LTg0MTUwNTA5Mjg4MDkwNjIzMA==,47,j_116150,10,Terminated,134172,134196,24,100,0.1
task_LTg0MTUwNTA5Mjg4MDkwNjIzMA==,12,j_571082,10,Terminated,652652,652674,22,100,0.1
task_LTg0MTUwNTA5Mjg4MDkwNjIzMA==,31,j_561852,10,Terminated,220684,220781,97,100,0.1
task_LTg0MTUwNTA5Mjg4MDkwNjIzMA==,14,j_449472,10,Terminated,220686,220753,67,100,0.1
task_LTg0MTUwNTA5Mjg4MDkwNjIzMA==,28,j_258056,10,Terminated,479951,479979,28,100,0.1
task_LTg0MTUwNTA5Mjg4MDkwNjIzMA==,29,j_561162,10,Terminated,134360,134424,64,100,0.1
task_LTg0MTUwNTA5Mjg4MDkwNjIzMA==,31,j_265732,10,Terminated,220833,220905,72,100,0.1
task_LTg0MTUwNTA5Mjg4MDkwNjIzMA==,31,j_60112,10,Terminated,134442,134474,32,100,0.1
task_LTg0MTUwNTA5Mjg4MDkwNjIzMA==,12,j_810176,10,Terminated,652848,652873,25,100,0.1
task_LTI0MjU2NDM0NTE3NDI0MzkwNjE=,24,j_526942,3,Terminated,91251,91291,40,100,0.39
task_MzQwMDQzNjY0MzkwNzU2ODYyMg==,16,j_488724,3,Terminated,264058,264257,199,100,0.39
task_LTg0MTUwNTA5Mjg4MDkwNjIzMA==,29,j_291319,10,Terminated,134491,134512,21,100,0.1
task_LTg0MTUwNTA5Mjg4MDkwNjIzMA==,13,j_766852,10,Terminated,307305,307341,36,100,0.1
task_MTY3NzU4MzIxMzMzNDg4OTMzOQ==,16,j_232948,3,Terminated,156137,156185,48,100,0.39
task_Mjc5MzA3NTE4MTEyMDI2MTQ2OQ==,16,j_232948,3,Terminated,156137,156215,78,100,0.39
task_LTE3Nzc5Mzc0NTEyODIyMTQwNTc=,16,j_232948,3,Terminated,156137,156167,30,100,0.39
task_LTg0MTUwNTA5Mjg4MDkwNjIzMA==,14,j_592976,10,Terminated,652940,652963,23,100,0.1
task_LTg0MTUwNTA5Mjg4MDkwNjIzMA==,39,j_153263,10,Terminated,652954,652976,22,100,0.1
task_MzQwMDQzNjY0MzkwNzU2ODYyMg==,13,j_112728,3,Terminated,177771,177855,84,100,0.39
task_LTg0MTUwNTA5Mjg4MDkwNjIzMA==,22,j_7095,10,Terminated,220992,221018,26,100,0.1
task_LTg0MTUwNTA5Mjg4MDkwNjIzMA==,35,j_737206,10,Terminated,307398,307437,39,100,0.1
task_LTg0MTUwNTA5Mjg4MDkwNjIzMA==,17,j_532408,10,Terminated,674620,674645,25,100,0.1
task_LTg0MTUwNTA5Mjg4MDkwNjIzMA==,19,j_612773,10,Terminated,221028,221060,32,100,0.1
task_LTg0MTUwNTA5Mjg4MDkwNjIzMA==,86,j_750892,10,Terminated,480234,480254,20,100,0.1
task_OTg1NjA1OTIxMzA4ODkxNg==,40,j_728570,8,Terminated,199435,199534,99,100,0.59
task_LTg0MTUwNTA5Mjg4MDkwNjIzMA==,14,j_363348,10,Terminated,221099,221121,22,100,0.1
task_LTg0MTUwNTA5Mjg4MDkwNjIzMA==,24,j_97012,10,Terminated,480317,480338,21,100,0.1
task_LTg0MTUwNTA5Mjg4MDkwNjIzMA==,19,j_285512,10,Terminated,566737,566776,39,100,0.1
task_MzQwMDQzNjY0MzkwNzU2ODYyMg==,82,j_357880,3,Terminated,372346,372367,21,100,0.39
task_LTg0MTUwNTA5Mjg4MDkwNjIzMA==,17,j_614184,10,Terminated,674747,674770,23,100,0.1
task_LTI0MjU2NDM0NTE3NDI0MzkwNjE=,82,j_357880,3,Terminated,372347,372518,171,100,0.39
task_MzQwMDQzNjY0MzkwNzU2ODYyMg==,29,j_491251,3,Terminated,588354,588388,34,100,0.19
task_LTg0MTUwNTA5Mjg4MDkwNjIzMA==,30,j_820370,10,Terminated,134758,134789,31,100,0.1
task_LTI0MjU2NDM0NTE3NDI0MzkwNjE=,22,j_373295,3,Terminated,437171,437199,28,100,0.39
task_LTg0MTUwNTA5Mjg4MDkwNjIzMA==,16,j_83339,10,Terminated,221179,221205,26,100,0.1
task_LTg0MTUwNTA5Mjg4MDkwNjIzMA==,44,j_625522,10,Terminated,221191,221224,33,100,0.1
task_LTg0MTUwNTA5Mjg4MDkwNjIzMA==,30,j_762273,10,Terminated,134802,134834,32,100,0.1
task_LTg0MTUwNTA5Mjg4MDkwNjIzMA==,98,j_763233,10,Terminated,221233,221263,30,100,0.1
task_LTg0MTUwNTA5Mjg4MDkwNjIzMA==,14,j_697760,10,Terminated,502065,502086,21,100,0.1
task_LTg0MTUwNTA5Mjg4MDkwNjIzMA==,38,j_457968,10,Terminated,307676,307699,23,100,0.1
task_LTI0MjU2NDM0NTE3NDI0MzkwNjE=,69,j_459820,3,Terminated,372488,372543,55,100,0.39
task_MzQwMDQzNjY0MzkwNzU2ODYyMg==,69,j_459820,3,Terminated,372488,372509,21,100,0.39
task_LTg0MTUwNTA5Mjg4MDkwNjIzMA==,11,j_164684,10,Terminated,653291,653321,30,100,0.1
task_LTg0MTUwNTA5Mjg4MDkwNjIzMA==,28,j_15310,10,Terminated,134893,134915,22,100,0.1
task_LTg0MTUwNTA5Mjg4MDkwNjIzMA==,21,j_630283,10,Terminated,566896,566920,24,100,0.1
task_LTg0MTUwNTA5Mjg4MDkwNjIzMA==,14,j_474926,10,Terminated,221317,221347,30,100,0.1
task_LTg0MTUwNTA5Mjg4MDkwNjIzMA==,17,j_735391,10,Terminated,674943,674963,20,100,0.1
task_LTg0MTUwNTA5Mjg4MDkwNjIzMA==,32,j_851985,10,Terminated,566962,566987,25,100,0.1
task_LTg0MTUwNTA5Mjg4MDkwNjIzMA==,59,j_143719,10,Terminated,307765,307795,30,100,0.1
task_LTg0MTUwNTA5Mjg4MDkwNjIzMA==,38,j_121361,10,Terminated,134990,135013,23,100,0.1
task_LTg0MTUwNTA5Mjg4MDkwNjIzMA==,12,j_16902,10,Terminated,566997,567017,20,100,0.1
task_LTg0MTUwNTA5Mjg4MDkwNjIzMA==,17,j_411795,10,Terminated,480611,480634,23,100,0.1
task_OTg1NjA1OTIxMzA4ODkxNg==,29,j_658422,8,Terminated,113416,113463,47,100,0.59
task_ODYzMjgxNTM3NDQ2NzUwMjQxMg==,27,j_663093,8,Terminated,329416,329465,49,100,0.59
task_ODYzMjgxNTM3NDQ2NzUwMjQxMg==,11,j_658422,8,Terminated,113416,113474,58,100,0.59
task_ODYzMjgxNTM3NDQ2NzUwMjQxMg==,11,j_165827,8,Terminated,372617,372641,24,100,0.59
task_ODYzMjgxNTM3NDQ2NzUwMjQxMg==,19,j_387003,8,Terminated,135018,135059,41,100,0.59
task_ODYzMjgxNTM3NDQ2NzUwMjQxMg==,19,j_337190,8,Terminated,653419,653442,23,100,0.59
task_OTg1NjA1OTIxMzA4ODkxNg==,29,j_25565,8,Terminated,199826,199862,36,100,0.59
task_ODYzMjgxNTM3NDQ2NzUwMjQxMg==,11,j_25565,8,Terminated,199826,199891,65,100,0.59
task_ODYzMjgxNTM3NDQ2NzUwMjQxMg==,11,j_419084,8,Terminated,372628,372702,74,100,0.59
task_OTg1NjA1OTIxMzA4ODkxNg==,29,j_419084,8,Terminated,372629,372676,47,100,0.59
task_ODYzMjgxNTM3NDQ2NzUwMjQxMg==,19,j_523236,8,Terminated,394232,394322,90,100,0.59
task_OTg1NjA1OTIxMzA4ODkxNg==,53,j_523236,8,Terminated,394232,394293,61,100,0.59
task_LTg0MTUwNTA5Mjg4MDkwNjIzMA==,12,j_389453,10,Terminated,567050,567075,25,100,0.1
task_LTg0MTUwNTA5Mjg4MDkwNjIzMA==,28,j_260718,10,Terminated,221450,221480,30,100,0.1
task_LTg0MTUwNTA5Mjg4MDkwNjIzMA==,24,j_126480,10,Terminated,502252,502285,33,100,0.1
task_ODYzMjgxNTM3NDQ2NzUwMjQxMg==,19,j_434911,8,Terminated,307852,307897,45,100,0.59
task_LTg0MTUwNTA5Mjg4MDkwNjIzMA==,25,j_108702,10,Terminated,567052,567086,34,100,0.1
task_LTg0MTUwNTA5Mjg4MDkwNjIzMA==,86,j_540773,10,Terminated,221453,221492,39,100,0.1
task_LTg0MTUwNTA5Mjg4MDkwNjIzMA==,34,j_493473,10,Terminated,135063,135084,21,100,0.1
task_LTI0MjU2NDM0NTE3NDI0MzkwNjE=,14,j_614326,12,Terminated,588672,588857,185,100,0.39
task_LTg0MTUwNTA5Mjg4MDkwNjIzMA==,31,j_20026,10,Terminated,567080,567107,27,100,0.1
task_LTI0MjU2NDM0NTE3NDI0MzkwNjE=,20,j_423541,3,Terminated,156691,156732,41,100,0.39
task_LTI0MjU2NDM0NTE3NDI0MzkwNjE=,20,j_232837,3,Terminated,156691,156730,39,100,0.39
task_ODYzMjgxNTM3NDQ2NzUwMjQxMg==,11,j_278753,8,Terminated,286292,286340,48,100,0.59
task_LTg0MTUwNTA5Mjg4MDkwNjIzMA==,21,j_618519,10,Terminated,221493,221516,23,100,0.1
task_LTg0MTUwNTA5Mjg4MDkwNjIzMA==,10,j_534191,8,Terminated,631895,631982,87,100,0.1
task_LTg0MTUwNTA5Mjg4MDkwNjIzMA==,17,j_877109,10,Terminated,675100,675155,55,100,0.1
task_LTg0MTUwNTA5Mjg4MDkwNjIzMA==,25,j_324386,10,Terminated,567114,567140,26,100,0.1
task_LTI0MjU2NDM0NTE3NDI0MzkwNjE=,27,j_547335,3,Terminated,135123,135176,53,100,0.39
task_MzQwMDQzNjY0MzkwNzU2ODYyMg==,27,j_547335,3,Terminated,135123,135145,22,100,0.39
task_LTg0MTUwNTA5Mjg4MDkwNjIzMA==,22,j_745697,10,Terminated,221525,221550,25,100,0.1
task_MzQwMDQzNjY0MzkwNzU2ODYyMg==,48,j_368791,3,Terminated,545537,545593,56,100,0.2
task_LTg0MTUwNTA5Mjg4MDkwNjIzMA==,30,j_267809,10,Terminated,502356,502376,20,100,0.1
task_LTg0MTUwNTA5Mjg4MDkwNjIzMA==,41,j_809492,10,Terminated,653582,653608,26,100,0.1
task_OTg1NjA1OTIxMzA4ODkxNg==,54,j_133777,8,Terminated,394383,394404,21,100,0.59
task_ODYzMjgxNTM3NDQ2NzUwMjQxMg==,19,j_133777,8,Terminated,394383,394437,54,100,0.59
task_LTI0MjU2NDM0NTE3NDI0MzkwNjE=,34,j_184434,3,Terminated,264790,264833,43,100,0.39
task_LTI0MjU2NDM0NTE3NDI0MzkwNjE=,20,j_902463,3,Terminated,221600,221639,39,100,0.39
task_LTg0MTUwNTA5Mjg4MDkwNjIzMA==,48,j_639259,10,Terminated,308038,308074,36,100,0.1
task_LTg0MTUwNTA5Mjg4MDkwNjIzMA==,92,j_713575,10,Terminated,221646,221678,32,100,0.1
task_LTg0MTUwNTA5Mjg4MDkwNjIzMA==,28,j_285448,10,Terminated,135249,135272,23,100,0.1
task_LTg0MTUwNTA5Mjg4MDkwNjIzMA==,12,j_215420,10,Terminated,567256,567281,25,100,0.1
task_LTg0MTUwNTA5Mjg4MDkwNjIzMA==,17,j_2324,10,Terminated,675259,675283,24,100,0.1
task_LTg0MTUwNTA5Mjg4MDkwNjIzMA==,30,j_737515,10,Terminated,567287,567317,30,100,0.1
task_LTg0MTUwNTA5Mjg4MDkwNjIzMA==,99,j_72126,10,Terminated,480890,480921,31,100,0.1
task_LTg0MTUwNTA5Mjg4MDkwNjIzMA==,12,j_79169,10,Terminated,567308,567334,26,100,0.1
task_LTg0MTUwNTA5Mjg4MDkwNjIzMA==,45,j_419571,10,Terminated,135325,135349,24,100,0.1
task_LTg0MTUwNTA5Mjg4MDkwNjIzMA==,17,j_131801,10,Terminated,567333,567366,33,100,0.1
task_LTg0MTUwNTA5Mjg4MDkwNjIzMA==,90,j_223899,10,Terminated,221749,221801,52,100,0.1
task_LTg0MTUwNTA5Mjg4MDkwNjIzMA==,37,j_105672,10,Terminated,653758,653791,33,100,0.1
task_LTg0MTUwNTA5Mjg4MDkwNjIzMA==,24,j_908729,10,Terminated,567378,567408,30,100,0.1
task_LTg0MTUwNTA5Mjg4MDkwNjIzMA==,31,j_101556,10,Terminated,567386,567414,28,100,0.1
task_LTg0MTUwNTA5Mjg4MDkwNjIzMA==,10,j_712637,10,Terminated,135387,135407,20,100,0.1
task_LTg0MTUwNTA5Mjg4MDkwNjIzMA==,18,j_199896,10,Terminated,481026,481050,24,100,0.1
task_LTg0MTUwNTA5Mjg4MDkwNjIzMA==,55,j_523537,10,Terminated,653827,653849,22,100,0.1
task_LTg0MTUwNTA5Mjg4MDkwNjIzMA==,14,j_10505,10,Terminated,567433,567459,26,100,0.1
task_LTg0MTUwNTA5Mjg4MDkwNjIzMA==,28,j_615587,10,Terminated,135454,135477,23,100,0.1
task_LTg0MTUwNTA5Mjg4MDkwNjIzMA==,39,j_533198,10,Terminated,221859,221909,50,100,0.1
task_LTg0MTUwNTA5Mjg4MDkwNjIzMA==,40,j_563920,10,Terminated,135470,135496,26,100,0.1
task_LTg0MTUwNTA5Mjg4MDkwNjIzMA==,12,j_510935,10,Terminated,135480,135502,22,100,0.1
task_LTg0MTUwNTA5Mjg4MDkwNjIzMA==,15,j_28688,10,Terminated,221893,221925,32,100,0.1
task_LTg0MTUwNTA5Mjg4MDkwNjIzMA==,31,j_839615,10,Terminated,567536,567566,30,100,0.1
task_LTg0MTUwNTA5Mjg4MDkwNjIzMA==,24,j_304541,10,Terminated,567539,567562,23,100,0.1
task_LTg0MTUwNTA5Mjg4MDkwNjIzMA==,19,j_261185,10,Terminated,653958,653988,30,100,0.1
task_LTI0MjU2NDM0NTE3NDI0MzkwNjE=,99,j_325501,3,Terminated,221973,222032,59,100,0.39
task_LTg0MTUwNTA5Mjg4MDkwNjIzMA==,10,j_698428,10,Terminated,135580,135605,25,100,0.1
task_LTg0MTUwNTA5Mjg4MDkwNjIzMA==,15,j_309147,10,Terminated,567580,567601,21,100,0.1
task_LTg0MTUwNTA5Mjg4MDkwNjIzMA==,47,j_118163,10,Terminated,222011,222047,36,100,0.1
task_LTg0MTUwNTA5Mjg4MDkwNjIzMA==,11,j_543162,10,Terminated,135615,135645,30,100,0.1
task_LTg0MTUwNTA5Mjg4MDkwNjIzMA==,24,j_189780,10,Terminated,567620,567656,36,100,0.1
task_LTg0MTUwNTA5Mjg4MDkwNjIzMA==,36,j_172132,10,Terminated,135624,135647,23,100,0.1
task_ODg3NTU4NTE3NDcxODA4NjA5Ng==,40,j_469216,3,Terminated,459638,459687,49,100,0.39
task_LTg0MTUwNTA5Mjg4MDkwNjIzMA==,25,j_262469,10,Terminated,135642,135666,24,100,0.1
task_LTg0MTUwNTA5Mjg4MDkwNjIzMA==,81,j_742764,10,Terminated,222097,222137,40,100,0.1
task_LTg0MTUwNTA5Mjg4MDkwNjIzMA==,16,j_796757,10,Terminated,654123,654147,24,100,0.1
task_NzQ3MjEzNzg0MzE5NDE5NzM1Mg==,18,j_374265,3,Terminated,589339,589449,110,100,1.53
task_MTY3NzU4MzIxMzMzNDg4OTMzOQ==,34,j_8985,3,Terminated,459761,459845,84,100,0.39
task_Mjc5MzA3NTE4MTEyMDI2MTQ2OQ==,34,j_8985,3,Terminated,459761,459876,115,100,0.39
task_LTE3Nzc5Mzc0NTEyODIyMTQwNTc=,34,j_8985,3,Terminated,459761,459803,42,100,0.39
task_MzQwMDQzNjY0MzkwNzU2ODYyMg==,13,j_477291,3,Terminated,92573,92652,79,100,0.39
task_LTg0MTUwNTA5Mjg4MDkwNjIzMA==,43,j_313277,10,Terminated,308594,308626,32,100,0.1
task_LTg0MTUwNTA5Mjg4MDkwNjIzMA==,11,j_902022,10,Terminated,135795,135834,39,100,0.1
task_LTg0MTUwNTA5Mjg4MDkwNjIzMA==,29,j_861833,10,Terminated,567813,567835,22,100,0.1
task_LTg0MTUwNTA5Mjg4MDkwNjIzMA==,24,j_313173,10,Terminated,135816,135845,29,100,0.1
task_LTg0MTUwNTA5Mjg4MDkwNjIzMA==,14,j_630139,10,Terminated,222217,222248,31,100,0.1
task_LTg0MTUwNTA5Mjg4MDkwNjIzMA==,19,j_646411,10,Terminated,481435,481455,20,100,0.1
task_LTg0MTUwNTA5Mjg4MDkwNjIzMA==,60,j_549170,10,Terminated,222242,222274,32,100,0.1
task_LTg0MTUwNTA5Mjg4MDkwNjIzMA==,34,j_513941,10,Terminated,654244,654273,29,100,0.1
task_LTg0MTUwNTA5Mjg4MDkwNjIzMA==,19,j_915934,10,Terminated,308644,308681,37,100,0.1
task_LTg0MTUwNTA5Mjg4MDkwNjIzMA==,18,j_677399,10,Terminated,481446,481467,21,100,0.1
task_LTg0MTUwNTA5Mjg4MDkwNjIzMA==,25,j_774551,10,Terminated,567848,567872,24,100,0.1
task_LTg0MTUwNTA5Mjg4MDkwNjIzMA==,23,j_768075,10,Terminated,567858,567879,21,100,0.1
task_LTg0MTUwNTA5Mjg4MDkwNjIzMA==,16,j_863665,10,Terminated,567869,567896,27,100,0.1
task_LTg0MTUwNTA5Mjg4MDkwNjIzMA==,18,j_228362,10,Terminated,481474,481499,25,100,0.1
task_LTg0MTUwNTA5Mjg4MDkwNjIzMA==,11,j_287189,10,Terminated,157478,157499,21,100,0.1
task_LTg0MTUwNTA5Mjg4MDkwNjIzMA==,11,j_347674,10,Terminated,135879,135903,24,100,0.1
task_LTg0MTUwNTA5Mjg4MDkwNjIzMA==,23,j_839802,10,Terminated,481529,481552,23,100,0.1
task_LTg0MTUwNTA5Mjg4MDkwNjIzMA==,22,j_360163,10,Terminated,481529,481550,21,100,0.1
task_LTg0MTUwNTA5Mjg4MDkwNjIzMA==,19,j_645681,10,Terminated,481529,481554,25,100,0.1
task_LTg0MTUwNTA5Mjg4MDkwNjIzMA==,34,j_187612,10,Terminated,654365,654387,22,100,0.1
task_LTg0MTUwNTA5Mjg4MDkwNjIzMA==,30,j_55385,8,Terminated,114379,114414,35,100,0.1
task_MzQwMDQzNjY0MzkwNzU2ODYyMg==,70,j_308254,3,Terminated,222399,222449,50,100,0.39
task_LTI0MjU2NDM0NTE3NDI0MzkwNjE=,70,j_308254,3,Terminated,222399,222480,81,100,0.39
task_LTI0MjU2NDM0NTE3NDI0MzkwNjE=,59,j_444711,3,Terminated,222408,222473,65,100,0.39
task_LTg0MTUwNTA5Mjg4MDkwNjIzMA==,26,j_879494,10,Terminated,568022,568053,31,100,0.1
task_LTg0MTUwNTA5Mjg4MDkwNjIzMA==,18,j_353043,10,Terminated,481673,481698,25,100,0.1
task_LTg0MTUwNTA5Mjg4MDkwNjIzMA==,11,j_448945,10,Terminated,136084,136109,25,100,0.1
task_LTg0MTUwNTA5Mjg4MDkwNjIzMA==,14,j_656837,10,Terminated,222484,222508,24,100,0.1
task_LTg0MTUwNTA5Mjg4MDkwNjIzMA==,26,j_694108,10,Terminated,568092,568147,55,100,0.1
task_LTg0MTUwNTA5Mjg4MDkwNjIzMA==,44,j_890614,10,Terminated,308904,308945,41,100,0.1
task_LTg0MTUwNTA5Mjg4MDkwNjIzMA==,13,j_475917,10,Terminated,222528,222554,26,100,0.1
task_LTg0MTUwNTA5Mjg4MDkwNjIzMA==,74,j_110814,10,Terminated,222536,222559,23,100,0.1
task_LTg0MTUwNTA5Mjg4MDkwNjIzMA==,36,j_709416,10,Terminated,481739,481765,26,100,0.1
task_LTI0MjU2NDM0NTE3NDI0MzkwNjE=,65,j_207534,3,Terminated,222540,222582,42,100,0.39
task_LTg0MTUwNTA5Mjg4MDkwNjIzMA==,10,j_312649,10,Terminated,676152,676180,28,100,0.1
task_LTg0MTUwNTA5Mjg4MDkwNjIzMA==,19,j_768757,10,Terminated,481753,481782,29,100,0.1
task_LTg0MTUwNTA5Mjg4MDkwNjIzMA==,43,j_796185,10,Terminated,308998,309030,32,100,0.1
task_ODg3NTU4NTE3NDcxODA4NjA5Ng==,13,j_425236,3,Terminated,201061,201178,117,100,0.05
task_LTg0MTUwNTA5Mjg4MDkwNjIzMA==,34,j_681933,10,Terminated,481862,481895,33,100,0.1
task_LTI0MjU2NDM0NTE3NDI0MzkwNjE=,13,j_831079,3,Terminated,460265,460304,39,100,0.39
task_LTg0MTUwNTA5Mjg4MDkwNjIzMA==,23,j_482021,10,Terminated,503471,503495,24,100,0.1
task_LTg0MTUwNTA5Mjg4MDkwNjIzMA==,26,j_597090,10,Terminated,503474,503498,24,100,0.1
task_LTg0MTUwNTA5Mjg4MDkwNjIzMA==,17,j_241393,8,Terminated,201106,201140,34,100,0.1
task_LTg0MTUwNTA5Mjg4MDkwNjIzMA==,16,j_249514,10,Terminated,481918,481944,26,100,0.1
task_LTg0MTUwNTA5Mjg4MDkwNjIzMA==,18,j_28134,10,Terminated,503524,503547,23,100,0.1
task_LTg0MTUwNTA5Mjg4MDkwNjIzMA==,10,j_105377,10,Terminated,222730,222754,24,100,0.1
task_LTg0MTUwNTA5Mjg4MDkwNjIzMA==,19,j_320542,10,Terminated,568333,568368,35,100,0.1
task_LTg0MTUwNTA5Mjg4MDkwNjIzMA==,10,j_684635,10,Terminated,568339,568366,27,100,0.1
task_LTg0MTUwNTA5Mjg4MDkwNjIzMA==,14,j_225369,10,Terminated,222766,222814,48,100,0.1
task_LTg0MTUwNTA5Mjg4MDkwNjIzMA==,17,j_198099,10,Terminated,568376,568406,30,100,0.1
task_LTg0MTUwNTA5Mjg4MDkwNjIzMA==,33,j_422269,10,Terminated,481984,482021,37,100,0.1
task_LTg0MTUwNTA5Mjg4MDkwNjIzMA==,23,j_839579,10,Terminated,568385,568416,31,100,0.1
task_LTg0MTUwNTA5Mjg4MDkwNjIzMA==,46,j_503603,10,Terminated,654794,654823,29,100,0.1
task_LTg0MTUwNTA5Mjg4MDkwNjIzMA==,12,j_187569,10,Terminated,654796,654832,36,100,0.1
task_LTg0MTUwNTA5Mjg4MDkwNjIzMA==,70,j_386824,10,Terminated,482035,482067,32,100,0.1
task_LTg0MTUwNTA5Mjg4MDkwNjIzMA==,29,j_854937,10,Terminated,482052,482075,23,100,0.1
task_LTg0MTUwNTA5Mjg4MDkwNjIzMA==,34,j_56215,10,Terminated,309327,309375,48,100,0.1
task_LTg0MTUwNTA5Mjg4MDkwNjIzMA==,15,j_545495,10,Terminated,482139,482164,25,100,0.1
task_LTg0MTUwNTA5Mjg4MDkwNjIzMA==,44,j_611246,10,Terminated,222956,222984,28,100,0.1
task_MzQwMDQzNjY0MzkwNzU2ODYyMg==,15,j_236475,12,Terminated,93363,93385,22,100,0.39
task_LTg0MTUwNTA5Mjg4MDkwNjIzMA==,37,j_562776,10,Terminated,654964,654987,23,100,0.1
task_LTg0MTUwNTA5Mjg4MDkwNjIzMA==,10,j_324832,10,Terminated,568584,568612,28,100,0.1
task_LTg0MTUwNTA5Mjg4MDkwNjIzMA==,16,j_800390,10,Terminated,482187,482211,24,100,0.1
task_LTg0MTUwNTA5Mjg4MDkwNjIzMA==,31,j_50103,10,Terminated,482189,482222,33,100,0.1
task_LTg0MTUwNTA5Mjg4MDkwNjIzMA==,17,j_843074,10,Terminated,482202,482227,25,100,0.1
task_LTI0MjU2NDM0NTE3NDI0MzkwNjE=,22,j_44754,3,Terminated,287864,287901,37,100,0.39
task_MzQwMDQzNjY0MzkwNzU2ODYyMg==,48,j_522207,3,Terminated,201493,201544,51,100,0.2
task_LTg0MTUwNTA5Mjg4MDkwNjIzMA==,17,j_361151,10,Terminated,655096,655132,36,100,0.1
task_MzQwMDQzNjY0MzkwNzU2ODYyMg==,39,j_463936,3,Terminated,590320,590352,32,100,0.19
task_LTg0MTUwNTA5Mjg4MDkwNjIzMA==,19,j_600221,10,Terminated,223127,223175,48,100,0.1
task_LTg0MTUwNTA5Mjg4MDkwNjIzMA==,32,j_63974,10,Terminated,655145,655173,28,100,0.1
task_LTg0MTUwNTA5Mjg4MDkwNjIzMA==,86,j_714118,10,Terminated,136750,136932,182,75,0.1
task_MzQwMDQzNjY0MzkwNzU2ODYyMg==,22,j_778785,3,Terminated,568758,568940,182,100,0.39
task_MzQwMDQzNjY0MzkwNzU2ODYyMg==,14,j_69828,12,Terminated,115187,115256,69,100,0.39
task_LTg5MTI5MTc1ODQzMjE2MTczMTk=,18,j_555104,3,Terminated,266389,266445,56,100,0.79
task_ODYzMjgxNTM3NDQ2NzUwMjQxMg==,27,j_214558,8,Terminated,504016,504057,41,100,0.59
task_OTg1NjA1OTIxMzA4ODkxNg==,55,j_273274,8,Terminated,568821,568851,30,100,0.59
task_ODYzMjgxNTM3NDQ2NzUwMjQxMg==,19,j_273274,8,Terminated,568821,568872,51,100,0.59
task_OTg1NjA1OTIxMzA4ODkxNg==,55,j_914629,8,Terminated,396021,396047,26,100,0.59
task_ODYzMjgxNTM3NDQ2NzUwMjQxMg==,19,j_914629,8,Terminated,396021,396098,77,100,0.59
task_ODYzMjgxNTM3NDQ2NzUwMjQxMg==,27,j_379740,8,Terminated,417625,417675,50,100,0.59
task_ODYzMjgxNTM3NDQ2NzUwMjQxMg==,11,j_635198,8,Terminated,115228,115289,61,100,0.59
task_ODYzMjgxNTM3NDQ2NzUwMjQxMg==,19,j_200164,8,Terminated,655232,655283,51,100,0.59
task_OTg1NjA1OTIxMzA4ODkxNg==,87,j_913107,8,Terminated,460854,461050,196,100,0.59
task_MzQwMDQzNjY0MzkwNzU2ODYyMg==,13,j_406631,3,Terminated,136869,136889,20,100,1.91
task_MzQwMDQzNjY0MzkwNzU2ODYyMg==,65,j_233123,3,Terminated,201673,201777,104,100,0.24
task_LTg0MTUwNTA5Mjg4MDkwNjIzMA==,36,j_905406,10,Terminated,309684,309708,24,100,0.1
task_LTg0MTUwNTA5Mjg4MDkwNjIzMA==,34,j_815560,10,Terminated,223288,223327,39,100,0.1
task_ODg3NTU4NTE3NDcxODA4NjA5Ng==,46,j_410595,3,Terminated,201714,201881,167,100,0.39
task_LTg0MTUwNTA5Mjg4MDkwNjIzMA==,21,j_633333,10,Terminated,482551,482574,23,100,0.1
task_MzQwMDQzNjY0MzkwNzU2ODYyMg==,22,j_189139,3,Terminated,288179,288292,113,100,0.39
task_LTI0MjU2NDM0NTE3NDI0MzkwNjE=,22,j_189139,3,Terminated,288179,288320,141,100,0.39
task_LTg0MTUwNTA5Mjg4MDkwNjIzMA==,22,j_616309,10,Terminated,482603,482638,35,100,0.1
task_LTg0MTUwNTA5Mjg4MDkwNjIzMA==,15,j_243490,10,Terminated,331415,331439,24,100,0.1
task_LTg0MTUwNTA5Mjg4MDkwNjIzMA==,13,j_533903,10,Terminated,158662,158684,22,100,0.1
task_OTg1NjA1OTIxMzA4ODkxNg==,28,j_27513,8,Terminated,331516,331587,71,100,0.59
task_OTg1NjA1OTIxMzA4ODkxNg==,11,j_80921,8,Terminated,439516,439576,60,100,0.59
task_OTg1NjA1OTIxMzA4ODkxNg==,12,j_749356,8,Terminated,633920,634074,154,100,0.59
task_LTg0MTUwNTA5Mjg4MDkwNjIzMA==,10,j_900363,10,Terminated,223527,223550,23,100,0.1
task_OTg1NjA1OTIxMzA4ODkxNg==,12,j_160015,8,Terminated,374730,374908,178,100,0.59
task_LTg0MTUwNTA5Mjg4MDkwNjIzMA==,21,j_403338,10,Terminated,482740,482763,23,100,0.1
task_LTg0MTUwNTA5Mjg4MDkwNjIzMA==,13,j_575460,10,Terminated,158752,158772,20,100,0.1
task_LTg0MTUwNTA5Mjg4MDkwNjIzMA==,92,j_784011,10,Terminated,482764,482790,26,100,0.1
task_LTg0MTUwNTA5Mjg4MDkwNjIzMA==,32,j_699421,10,Terminated,223623,223681,58,100,0.1
task_LTg0MTUwNTA5Mjg4MDkwNjIzMA==,70,j_327219,10,Terminated,482879,482910,31,100,0.1
task_LTg0MTUwNTA5Mjg4MDkwNjIzMA==,40,j_746034,10,Terminated,223711,223749,38,100,0.1
task_LTg0MTUwNTA5Mjg4MDkwNjIzMA==,16,j_703262,10,Terminated,482937,482976,39,100,0.1
task_MzQwMDQzNjY0MzkwNzU2ODYyMg==,23,j_284922,12,Terminated,180540,180571,31,100,0.39
task_OTg1NjA1OTIxMzA4ODkxNg==,11,j_117712,8,Terminated,612548,612614,66,100,0.59
task_LTg0MTUwNTA5Mjg4MDkwNjIzMA==,45,j_187922,10,Terminated,482954,482998,44,100,0.1
task_LTg0MTUwNTA5Mjg4MDkwNjIzMA==,28,j_747389,10,Terminated,223790,223824,34,100,0.1
task_LTg0MTUwNTA5Mjg4MDkwNjIzMA==,11,j_631763,10,Terminated,655852,655880,28,100,0.1
task_LTg0MTUwNTA5Mjg4MDkwNjIzMA==,10,j_401838,10,Terminated,569459,569484,25,100,0.1
task_LTg5MTI5MTc1ODQzMjE2MTczMTk=,15,j_416034,3,Terminated,655865,655914,49,100,0.79
task_LTg0MTUwNTA5Mjg4MDkwNjIzMA==,36,j_573136,10,Terminated,223869,223892,23,100,0.1
task_LTg0MTUwNTA5Mjg4MDkwNjIzMA==,13,j_173834,10,Terminated,159087,159109,22,100,0.1
task_LTg0MTUwNTA5Mjg4MDkwNjIzMA==,10,j_296375,10,Terminated,483091,483120,29,100,0.1
task_LTg0MTUwNTA5Mjg4MDkwNjIzMA==,15,j_446489,10,Terminated,310316,310354,38,100,0.1
task_LTg0MTUwNTA5Mjg4MDkwNjIzMA==,23,j_376150,10,Terminated,655927,655957,30,100,0.1
task_LTg0MTUwNTA5Mjg4MDkwNjIzMA==,13,j_233457,10,Terminated,159139,159162,23,100,0.1
task_LTg0MTUwNTA5Mjg4MDkwNjIzMA==,28,j_635933,10,Terminated,569566,569597,31,100,0.1
task_LTI0MjU2NDM0NTE3NDI0MzkwNjE=,10,j_868172,3,Terminated,634371,634398,27,100,0.39
task_LTg0MTUwNTA5Mjg4MDkwNjIzMA==,14,j_369665,10,Terminated,223976,224024,48,100,0.1
task_LTg0MTUwNTA5Mjg4MDkwNjIzMA==,10,j_487378,10,Terminated,310381,310410,29,100,0.1
task_LTg0MTUwNTA5Mjg4MDkwNjIzMA==,21,j_343510,10,Terminated,483193,483216,23,100,0.1
task_ODg3NTU4NTE3NDcxODA4NjA5Ng==,73,j_56520,3,Terminated,159245,159323,78,100,0.39
task_LTg0MTUwNTA5Mjg4MDkwNjIzMA==,14,j_319961,10,Terminated,656051,656073,22,100,0.1
task_LTg5MTI5MTc1ODQzMjE2MTczMTk=,40,j_434562,3,Terminated,94457,94560,103,100,0.79
task_LTg0MTUwNTA5Mjg4MDkwNjIzMA==,21,j_574876,10,Terminated,137677,137711,34,100,0.1
task_LTg0MTUwNTA5Mjg4MDkwNjIzMA==,15,j_479317,10,Terminated,483301,483324,23,100,0.1
task_LTg0MTUwNTA5Mjg4MDkwNjIzMA==,10,j_834940,10,Terminated,137707,137738,31,100,0.1
task_LTg0MTUwNTA5Mjg4MDkwNjIzMA==,16,j_792652,8,Terminated,288907,288953,46,100,0.1
task_LTg5MTI5MTc1ODQzMjE2MTczMTk=,43,j_255453,3,Terminated,483310,483398,88,100,0.79
task_LTg0MTUwNTA5Mjg4MDkwNjIzMA==,22,j_265770,10,Terminated,569714,569747,33,100,0.1
task_MzQwMDQzNjY0MzkwNzU2ODYyMg==,18,j_298551,3,Terminated,440131,440180,49,100,0.39
task_LTg0MTUwNTA5Mjg4MDkwNjIzMA==,32,j_55357,10,Terminated,137732,137759,27,100,0.1
task_LTg0MTUwNTA5Mjg4MDkwNjIzMA==,20,j_445362,10,Terminated,310581,310608,27,100,0.1
task_LTg0MTUwNTA5Mjg4MDkwNjIzMA==,53,j_780313,10,Terminated,224189,224219,30,100,0.1
task_Mjc5MzA3NTE4MTEyMDI2MTQ2OQ==,13,j_165079,3,Terminated,202601,202684,83,100,0.39
task_LTE3Nzc5Mzc0NTEyODIyMTQwNTc=,13,j_165079,3,Terminated,202601,202636,35,100,0.39
task_MTY3NzU4MzIxMzMzNDg4OTMzOQ==,13,j_165079,3,Terminated,202601,202663,62,100,0.39
task_LTg0MTUwNTA5Mjg4MDkwNjIzMA==,18,j_302020,10,Terminated,224209,224236,27,100,0.1
task_LTg5MTI5MTc1ODQzMjE2MTczMTk=,42,j_325444,3,Terminated,137864,137992,128,100,0.79
task_LTg0MTUwNTA5Mjg4MDkwNjIzMA==,23,j_152797,10,Terminated,224293,224329,36,100,0.1
task_LTg0MTUwNTA5Mjg4MDkwNjIzMA==,31,j_868984,10,Terminated,137933,137961,28,100,0.1
task_LTg0MTUwNTA5Mjg4MDkwNjIzMA==,44,j_494976,10,Terminated,224333,224355,22,100,0.1
task_LTg0MTUwNTA5Mjg4MDkwNjIzMA==,31,j_764528,10,Terminated,483549,483573,24,100,0.1
task_LTg0MTUwNTA5Mjg4MDkwNjIzMA==,20,j_412903,10,Terminated,483553,483574,21,100,0.1
task_LTg0MTUwNTA5Mjg4MDkwNjIzMA==,23,j_850069,10,Terminated,569962,569996,34,100,0.1
task_LTg0MTUwNTA5Mjg4MDkwNjIzMA==,27,j_418961,10,Terminated,137971,137991,20,100,0.1
task_OTg1NjA1OTIxMzA4ODkxNg==,100,j_109674,8,Terminated,397172,397361,189,100,0.59
task_MzQwMDQzNjY0MzkwNzU2ODYyMg==,68,j_379440,3,Terminated,224410,224438,28,100,0.39
task_LTI0MjU2NDM0NTE3NDI0MzkwNjE=,68,j_379440,3,Terminated,224410,224496,86,100,0.39
task_LTg0MTUwNTA5Mjg4MDkwNjIzMA==,14,j_327482,10,Terminated,570015,570049,34,100,0.1
task_LTg0MTUwNTA5Mjg4MDkwNjIzMA==,10,j_478175,10,Terminated,159664,159688,24,100,0.1
task_LTI0MjU2NDM0NTE3NDI0MzkwNjE=,59,j_250300,3,Terminated,224476,224526,50,100,0.39
task_LTg0MTUwNTA5Mjg4MDkwNjIzMA==,19,j_197253,10,Terminated,483687,483726,39,100,0.1
task_LTg0MTUwNTA5Mjg4MDkwNjIzMA==,36,j_868841,10,Terminated,310888,310910,22,100,0.1
task_LTg0MTUwNTA5Mjg4MDkwNjIzMA==,24,j_898390,10,Terminated,224517,224548,31,100,0.1
task_LTI0MjU2NDM0NTE3NDI0MzkwNjE=,68,j_363639,3,Terminated,224528,224577,49,100,0.39
task_LTI0MjU2NDM0NTE3NDI0MzkwNjE=,99,j_209899,3,Terminated,116584,116654,70,100,0.39
task_MzQwMDQzNjY0MzkwNzU2ODYyMg==,99,j_209899,3,Terminated,116585,116610,25,100,0.39
task_LTg0MTUwNTA5Mjg4MDkwNjIzMA==,16,j_217283,10,Terminated,224609,224645,36,100,0.1
task_LTg0MTUwNTA5Mjg4MDkwNjIzMA==,31,j_825064,10,Terminated,224611,224656,45,100,0.1
task_LTg0MTUwNTA5Mjg4MDkwNjIzMA==,31,j_498870,10,Terminated,138237,138257,20,100,0.1
task_LTg0MTUwNTA5Mjg4MDkwNjIzMA==,98,j_848446,10,Terminated,483840,483866,26,100,0.1
task_ODg3NTU4NTE3NDcxODA4NjA5Ng==,40,j_406360,3,Terminated,375853,375898,45,100,0.39
task_LTg0MTUwNTA5Mjg4MDkwNjIzMA==,33,j_29441,10,Terminated,224653,224684,31,100,0.1
task_LTg0MTUwNTA5Mjg4MDkwNjIzMA==,41,j_890876,10,Terminated,656666,656691,25,100,0.1
task_LTg0MTUwNTA5Mjg4MDkwNjIzMA==,14,j_701068,10,Terminated,224671,224700,29,100,0.1
task_LTg0MTUwNTA5Mjg4MDkwNjIzMA==,41,j_431633,10,Terminated,224682,224713,31,100,0.1
task_LTg0MTUwNTA5Mjg4MDkwNjIzMA==,14,j_560394,10,Terminated,570298,570323,25,100,0.1
task_LTg0MTUwNTA5Mjg4MDkwNjIzMA==,93,j_872154,10,Terminated,483915,483963,48,100,0.1
task_LTg0MTUwNTA5Mjg4MDkwNjIzMA==,10,j_827626,10,Terminated,570328,570355,27,100,0.1
task_LTg0MTUwNTA5Mjg4MDkwNjIzMA==,10,j_352814,10,Terminated,224736,224761,25,100,0.1
task_LTg0MTUwNTA5Mjg4MDkwNjIzMA==,21,j_439485,10,Terminated,570337,570365,28,100,0.1
task_LTg0MTUwNTA5Mjg4MDkwNjIzMA==,14,j_264529,10,Terminated,570358,570390,32,100,0.1
task_LTg0MTUwNTA5Mjg4MDkwNjIzMA==,39,j_416958,10,Terminated,224762,224790,28,100,0.1
task_LTg0MTUwNTA5Mjg4MDkwNjIzMA==,61,j_594476,10,Terminated,483990,484014,24,100,0.1
task_LTg0MTUwNTA5Mjg4MDkwNjIzMA==,33,j_691117,10,Terminated,224806,224844,38,100,0.1
task_LTg0MTUwNTA5Mjg4MDkwNjIzMA==,11,j_732541,10,Terminated,570411,570442,31,100,0.1
task_LTg0MTUwNTA5Mjg4MDkwNjIzMA==,13,j_862478,10,Terminated,656838,656879,41,100,0.1
task_LTg0MTUwNTA5Mjg4MDkwNjIzMA==,20,j_781748,10,Terminated,570440,570472,32,100,0.1
task_LTg0MTUwNTA5Mjg4MDkwNjIzMA==,13,j_257613,10,Terminated,570483,570519,36,100,0.1
task_MzQwMDQzNjY0MzkwNzU2ODYyMg==,26,j_314537,3,Terminated,224889,224909,20,100,0.39
task_LTI0MjU2NDM0NTE3NDI0MzkwNjE=,26,j_314537,3,Terminated,224890,224935,45,100,0.39
task_LTg0MTUwNTA5Mjg4MDkwNjIzMA==,15,j_318362,10,Terminated,224896,224956,60,100,0.1
task_LTg0MTUwNTA5Mjg4MDkwNjIzMA==,10,j_839828,10,Terminated,224896,224949,53,100,0.1
task_LTg0MTUwNTA5Mjg4MDkwNjIzMA==,44,j_78607,10,Terminated,656915,656978,63,100,0.1
task_LTg0MTUwNTA5Mjg4MDkwNjIzMA==,11,j_39090,10,Terminated,160122,160142,20,100,0.1
task_LTg0MTUwNTA5Mjg4MDkwNjIzMA==,14,j_897701,10,Terminated,570538,570561,23,100,0.1
task_LTI0MjU2NDM0NTE3NDI0MzkwNjE=,81,j_605803,3,Terminated,116951,117007,56,100,0.39
task_MzQwMDQzNjY0MzkwNzU2ODYyMg==,81,j_605803,3,Terminated,116951,116972,21,100,0.39
task_LTI0MjU2NDM0NTE3NDI0MzkwNjE=,69,j_547005,3,Terminated,116963,117008,45,100,0.39
task_LTg0MTUwNTA5Mjg4MDkwNjIzMA==,13,j_64468,10,Terminated,224964,225005,41,100,0.1
task_LTg0MTUwNTA5Mjg4MDkwNjIzMA==,42,j_95730,10,Terminated,224965,224996,31,100,0.1
task_LTg0MTUwNTA5Mjg4MDkwNjIzMA==,19,j_595607,10,Terminated,570570,570592,22,100,0.1
task_LTg0MTUwNTA5Mjg4MDkwNjIzMA==,45,j_301130,10,Terminated,311395,311444,49,100,0.1
task_LTg0MTUwNTA5Mjg4MDkwNjIzMA==,42,j_707515,10,Terminated,224997,225022,25,100,0.1
task_ODYzMjgxNTM3NDQ2NzUwMjQxMg==,21,j_213505,8,Terminated,225019,225065,46,100,0.59
task_ODYzMjgxNTM3NDQ2NzUwMjQxMg==,29,j_94583,8,Terminated,333020,333065,45,100,0.59
task_OTg1NjA1OTIxMzA4ODkxNg==,81,j_73874,8,Terminated,505823,505844,21,100,0.59
task_ODYzMjgxNTM3NDQ2NzUwMjQxMg==,29,j_73874,8,Terminated,505823,505864,41,100,0.59
task_OTg1NjA1OTIxMzA4ODkxNg==,57,j_265984,8,Terminated,138624,138644,20,100,0.59
task_ODYzMjgxNTM3NDQ2NzUwMjQxMg==,21,j_265984,8,Terminated,138624,138662,38,100,0.59
task_ODYzMjgxNTM3NDQ2NzUwMjQxMg==,13,j_298083,8,Terminated,376227,376272,45,100,0.59
task_LTg0MTUwNTA5Mjg4MDkwNjIzMA==,22,j_67583,10,Terminated,570633,570660,27,100,0.1
task_LTg0MTUwNTA5Mjg4MDkwNjIzMA==,51,j_578238,10,Terminated,225045,225077,32,100,0.1
task_LTg0MTUwNTA5Mjg4MDkwNjIzMA==,44,j_103498,10,Terminated,225062,225093,31,100,0.1
task_MzQwMDQzNjY0MzkwNzU2ODYyMg==,13,j_297845,3,Terminated,678685,678754,69,100,0.39
task_LTg0MTUwNTA5Mjg4MDkwNjIzMA==,14,j_731760,10,Terminated,484287,484312,25,100,0.1
task_ODg3NTU4NTE3NDcxODA4NjA5Ng==,79,j_327044,3,Terminated,635500,635547,47,100,0.39
task_LTg0MTUwNTA5Mjg4MDkwNjIzMA==,54,j_708872,8,Terminated,613901,613932,31,100,0.1
task_LTg0MTUwNTA5Mjg4MDkwNjIzMA==,29,j_865214,10,Terminated,225101,225126,25,100,0.1
task_MzQwMDQzNjY0MzkwNzU2ODYyMg==,91,j_679777,3,Terminated,117106,117305,199,100,0.39
task_LTg0MTUwNTA5Mjg4MDkwNjIzMA==,17,j_238939,10,Terminated,570744,570773,29,100,0.1
task_LTg0MTUwNTA5Mjg4MDkwNjIzMA==,19,j_72228,10,Terminated,484368,484393,25,100,0.1
task_LTg0MTUwNTA5Mjg4MDkwNjIzMA==,10,j_349202,10,Terminated,225178,225200,22,100,0.1
task_LTg0MTUwNTA5Mjg4MDkwNjIzMA==,11,j_606356,10,Terminated,570789,570814,25,100,0.1
task_LTg0MTUwNTA5Mjg4MDkwNjIzMA==,79,j_662029,10,Terminated,484402,484422,20,100,0.1
task_LTI0MjU2NDM0NTE3NDI0MzkwNjE=,21,j_154890,3,Terminated,160407,160448,41,100,0.39
task_LTI0MjU2NDM0NTE3NDI0MzkwNjE=,68,j_884537,3,Terminated,225213,225289,76,100,0.39
task_MzQwMDQzNjY0MzkwNzU2ODYyMg==,13,j_832945,3,Terminated,678819,678891,72,100,0.39
task_LTg0MTUwNTA5Mjg4MDkwNjIzMA==,33,j_761428,10,Terminated,225228,225259,31,100,0.1
task_LTg0MTUwNTA5Mjg4MDkwNjIzMA==,34,j_610972,10,Terminated,311630,311660,30,100,0.1
task_LTI0MjU2NDM0NTE3NDI0MzkwNjE=,41,j_629886,3,Terminated,635649,635704,55,100,0.39
task_LTg0MTUwNTA5Mjg4MDkwNjIzMA==,10,j_824390,10,Terminated,160449,160471,22,100,0.1
task_ODg3NTU4NTE3NDcxODA4NjA5Ng==,40,j_879288,3,Terminated,290067,290092,25,100,0.39
task_LTI0MjU2NDM0NTE3NDI0MzkwNjE=,11,j_147987,12,Terminated,441270,441316,46,100,0.39
task_LTg0MTUwNTA5Mjg4MDkwNjIzMA==,11,j_837008,10,Terminated,570911,570931,20,100,0.1
task_LTg0MTUwNTA5Mjg4MDkwNjIzMA==,20,j_856861,10,Terminated,311719,311779,60,100,0.1
task_MTY3NzU4MzIxMzMzNDg4OTMzOQ==,23,j_347547,3,Terminated,138934,138961,27,100,0.39
task_Mjc5MzA3NTE4MTEyMDI2MTQ2OQ==,23,j_347547,3,Terminated,138935,139018,83,100,0.39
task_LTg0MTUwNTA5Mjg4MDkwNjIzMA==,12,j_422630,10,Terminated,570956,570979,23,100,0.1
task_LTg0MTUwNTA5Mjg4MDkwNjIzMA==,81,j_212196,10,Terminated,484557,484584,27,100,0.1
task_LTI0MjU2NDM0NTE3NDI0MzkwNjE=,11,j_366998,12,Terminated,268559,268613,54,100,0.39
task_LTI0MjU2NDM0NTE3NDI0MzkwNjE=,20,j_598291,3,Terminated,225403,225465,62,100,0.39
task_LTI0MjU2NDM0NTE3NDI0MzkwNjE=,16,j_648650,3,Terminated,225407,225446,39,100,0.39
task_MzQwMDQzNjY0MzkwNzU2ODYyMg==,20,j_45941,3,Terminated,225407,225438,31,100,0.39
task_LTI0MjU2NDM0NTE3NDI0MzkwNjE=,20,j_45941,3,Terminated,225407,225461,54,100,0.39
task_LTI0MjU2NDM0NTE3NDI0MzkwNjE=,16,j_598561,3,Terminated,225408,225450,42,100,0.39
task_LTI0MjU2NDM0NTE3NDI0MzkwNjE=,17,j_492248,3,Terminated,225408,225445,37,100,0.39
task_LTg0MTUwNTA5Mjg4MDkwNjIzMA==,28,j_798677,10,Terminated,311820,311871,51,100,0.1
task_LTg0MTUwNTA5Mjg4MDkwNjIzMA==,20,j_545646,10,Terminated,571034,571072,38,100,0.1
task_MzQwMDQzNjY0MzkwNzU2ODYyMg==,24,j_673167,12,Terminated,290260,290281,21,100,0.39
task_LTg0MTUwNTA5Mjg4MDkwNjIzMA==,11,j_908754,10,Terminated,225481,225532,51,100,0.1
task_LTg0MTUwNTA5Mjg4MDkwNjIzMA==,34,j_5477,10,Terminated,657491,657536,45,100,0.1
task_LTg0MTUwNTA5Mjg4MDkwNjIzMA==,27,j_638265,10,Terminated,657492,657537,45,100,0.1
task_LTg0MTUwNTA5Mjg4MDkwNjIzMA==,28,j_628518,10,Terminated,311902,311933,31,100,0.1
task_LTg0MTUwNTA5Mjg4MDkwNjIzMA==,21,j_179352,10,Terminated,571113,571133,20,100,0.1
task_MzQwMDQzNjY0MzkwNzU2ODYyMg==,37,j_836569,12,Terminated,527944,527972,28,100,0.39
task_MzQwMDQzNjY0MzkwNzU2ODYyMg==,68,j_248088,12,Terminated,182349,182445,96,100,0.39
task_LTg0MTUwNTA5Mjg4MDkwNjIzMA==,72,j_110328,10,Terminated,484764,484791,27,100,0.1
task_LTg0MTUwNTA5Mjg4MDkwNjIzMA==,45,j_778004,10,Terminated,225570,225600,30,100,0.1
task_LTg0MTUwNTA5Mjg4MDkwNjIzMA==,28,j_497564,10,Terminated,225571,225608,37,100,0.1
task_LTg0MTUwNTA5Mjg4MDkwNjIzMA==,13,j_599181,10,Terminated,225578,225606,28,100,0.1
task_LTg0MTUwNTA5Mjg4MDkwNjIzMA==,28,j_370218,10,Terminated,225631,225670,39,100,0.1
task_LTg0MTUwNTA5Mjg4MDkwNjIzMA==,24,j_695709,10,Terminated,657636,657735,99,100,0.1
task_LTg0MTUwNTA5Mjg4MDkwNjIzMA==,43,j_269512,10,Terminated,225641,225681,40,100,0.1
task_LTg0MTUwNTA5Mjg4MDkwNjIzMA==,28,j_298778,10,Terminated,225644,225683,39,100,0.1
task_LTg0MTUwNTA5Mjg4MDkwNjIzMA==,25,j_496849,10,Terminated,312073,312104,31,100,0.1
task_Mjc5MzA3NTE4MTEyMDI2MTQ2OQ==,12,j_299084,3,Terminated,592879,592910,31,100,0.39
task_LTg0MTUwNTA5Mjg4MDkwNjIzMA==,21,j_373254,10,Terminated,484881,484910,29,100,0.1
task_LTg0MTUwNTA5Mjg4MDkwNjIzMA==,40,j_873733,10,Terminated,225681,225713,32,100,0.1
task_NzQ3MjEzNzg0MzE5NDE5NzM1Mg==,11,j_453784,3,Terminated,549689,549759,70,100,1.53
task_NzQ3MjEzNzg0MzE5NDE5NzM1Mg==,11,j_382664,3,Terminated,549693,549732,39,100,1.53
task_LTg0MTUwNTA5Mjg4MDkwNjIzMA==,30,j_92701,10,Terminated,225699,225720,21,100,0.1
task_LTI0MjU2NDM0NTE3NDI0MzkwNjE=,86,j_177667,3,Terminated,117739,117890,151,100,0.39
task_MzQwMDQzNjY0MzkwNzU2ODYyMg==,86,j_177667,3,Terminated,117739,117763,24,100,0.39
task_LTg0MTUwNTA5Mjg4MDkwNjIzMA==,13,j_512602,10,Terminated,484941,484969,28,100,0.1
task_LTg0MTUwNTA5Mjg4MDkwNjIzMA==,21,j_608219,10,Terminated,139343,139364,21,100,0.1
task_LTg0MTUwNTA5Mjg4MDkwNjIzMA==,20,j_262238,10,Terminated,225746,225772,26,100,0.1
task_LTg0MTUwNTA5Mjg4MDkwNjIzMA==,12,j_91468,10,Terminated,225751,225782,31,100,0.1
task_LTg0MTUwNTA5Mjg4MDkwNjIzMA==,21,j_392958,10,Terminated,571380,571401,21,100,0.1
task_LTI0MjU2NDM0NTE3NDI0MzkwNjE=,59,j_175571,3,Terminated,225829,225872,43,100,0.39
task_LTg0MTUwNTA5Mjg4MDkwNjIzMA==,43,j_529597,10,Terminated,485037,485069,32,100,0.1
task_LTg0MTUwNTA5Mjg4MDkwNjIzMA==,26,j_914601,10,Terminated,225838,225862,24,100,0.1
task_LTg0MTUwNTA5Mjg4MDkwNjIzMA==,11,j_714945,10,Terminated,312239,312280,41,100,0.1
task_LTg0MTUwNTA5Mjg4MDkwNjIzMA==,12,j_150999,10,Terminated,312250,312284,34,100,0.1
task_MzQwMDQzNjY0MzkwNzU2ODYyMg==,70,j_209202,3,Terminated,593086,593111,25,100,0.39
task_LTg0MTUwNTA5Mjg4MDkwNjIzMA==,32,j_718772,10,Terminated,225899,225936,37,100,0.1
task_LTg0MTUwNTA5Mjg4MDkwNjIzMA==,40,j_234561,10,Terminated,225906,225936,30,100,0.1
task_LTg0MTUwNTA5Mjg4MDkwNjIzMA==,12,j_443275,10,Terminated,312317,312353,36,100,0.1
task_LTg0MTUwNTA5Mjg4MDkwNjIzMA==,13,j_546236,10,Terminated,139520,139549,29,100,0.1
task_LTI0MjU2NDM0NTE3NDI0MzkwNjE=,70,j_225463,3,Terminated,161144,161189,45,100,0.39
task_LTg0MTUwNTA5Mjg4MDkwNjIzMA==,28,j_866773,10,Terminated,225966,225994,28,100,0.1
task_LTg0MTUwNTA5Mjg4MDkwNjIzMA==,35,j_756242,10,Terminated,312374,312403,29,100,0.1
task_LTg0MTUwNTA5Mjg4MDkwNjIzMA==,28,j_539107,10,Terminated,226028,226099,71,100,0.1
task_LTg0MTUwNTA5Mjg4MDkwNjIzMA==,42,j_96679,10,Terminated,658042,658079,37,100,0.1
task_LTg0MTUwNTA5Mjg4MDkwNjIzMA==,22,j_804024,10,Terminated,658054,658098,44,100,0.1
task_LTg0MTUwNTA5Mjg4MDkwNjIzMA==,43,j_684410,10,Terminated,658058,658089,31,100,0.1
task_LTI0MjU2NDM0NTE3NDI0MzkwNjE=,69,j_911767,3,Terminated,226070,226127,57,100,0.39
task_LTg0MTUwNTA5Mjg4MDkwNjIzMA==,12,j_412021,10,Terminated,485271,485294,23,100,0.1
task_LTg0MTUwNTA5Mjg4MDkwNjIzMA==,17,j_822589,10,Terminated,226105,226140,35,100,0.1
task_LTg0MTUwNTA5Mjg4MDkwNjIzMA==,10,j_358645,10,Terminated,571714,571741,27,100,0.1
task_LTg0MTUwNTA5Mjg4MDkwNjIzMA==,13,j_332212,10,Terminated,161324,161348,24,100,0.1
task_LTg0MTUwNTA5Mjg4MDkwNjIzMA==,29,j_675293,10,Terminated,226129,226153,24,100,0.1
task_LTg0MTUwNTA5Mjg4MDkwNjIzMA==,22,j_39215,10,Terminated,226148,226173,25,100,0.1
task_LTg0MTUwNTA5Mjg4MDkwNjIzMA==,10,j_215137,10,Terminated,226162,226187,25,100,0.1
task_LTI0MjU2NDM0NTE3NDI0MzkwNjE=,50,j_446962,3,Terminated,118162,118183,21,100,0.77
task_LTI0MjU2NDM0NTE3NDI0MzkwNjE=,69,j_833205,3,Terminated,226171,226216,45,100,0.39
task_LTg0MTUwNTA5Mjg4MDkwNjIzMA==,11,j_767899,10,Terminated,226176,226213,37,100,0.1
task_LTg0MTUwNTA5Mjg4MDkwNjIzMA==,15,j_821833,10,Terminated,139795,139816,21,100,0.1
task_LTg0MTUwNTA5Mjg4MDkwNjIzMA==,28,j_878326,10,Terminated,226206,226240,34,100,0.1
task_LTg0MTUwNTA5Mjg4MDkwNjIzMA==,13,j_727678,10,Terminated,161437,161504,67,100,0.1
task_LTg0MTUwNTA5Mjg4MDkwNjIzMA==,11,j_468265,10,Terminated,571843,571873,30,100,0.1
task_LTg0MTUwNTA5Mjg4MDkwNjIzMA==,11,j_298421,10,Terminated,571844,571876,32,100,0.1
task_LTg0MTUwNTA5Mjg4MDkwNjIzMA==,13,j_439090,10,Terminated,139846,139882,36,100,0.1
task_LTg0MTUwNTA5Mjg4MDkwNjIzMA==,24,j_778918,10,Terminated,312656,312700,44,100,0.1
task_LTg0MTUwNTA5Mjg4MDkwNjIzMA==,28,j_514067,10,Terminated,226268,226297,29,100,0.1
task_MzQwMDQzNjY0MzkwNzU2ODYyMg==,37,j_429186,12,Terminated,355885,355911,26,100,0.39
task_LTg0MTUwNTA5Mjg4MDkwNjIzMA==,22,j_796404,10,Terminated,571904,571924,20,100,0.1
task_LTI0MjU2NDM0NTE3NDI0MzkwNjE=,60,j_682069,3,Terminated,226308,226352,44,100,0.39
task_LTg0MTUwNTA5Mjg4MDkwNjIzMA==,89,j_183890,10,Terminated,485522,485545,23,100,0.1
task_LTg0MTUwNTA5Mjg4MDkwNjIzMA==,13,j_30814,10,Terminated,161529,161553,24,100,0.1
task_LTg0MTUwNTA5Mjg4MDkwNjIzMA==,12,j_742512,10,Terminated,226335,226361,26,100,0.1
task_LTI0MjU2NDM0NTE3NDI0MzkwNjE=,58,j_280749,3,Terminated,226338,226380,42,100,0.39
task_LTg0MTUwNTA5Mjg4MDkwNjIzMA==,12,j_236918,10,Terminated,226388,226450,62,100,0.1
task_LTg0MTUwNTA5Mjg4MDkwNjIzMA==,10,j_55310,10,Terminated,139990,140010,20,100,0.1
task_LTEyMjkyMzM5NDA0NjY2NzEwMzY=,25,j_658364,12,Terminated,312849,312882,33,100,0.96
task_LTcyMjgzNTU0Nzk1OTg3NTA5MzM=,25,j_658364,12,Terminated,312849,312878,29,100,1.34
task_LTI0MjU2NDM0NTE3NDI0MzkwNjE=,25,j_835467,3,Terminated,204863,204901,38,100,0.39
task_LTI0MjU2NDM0NTE3NDI0MzkwNjE=,22,j_509710,3,Terminated,312870,312906,36,100,0.39
task_LTg0MTUwNTA5Mjg4MDkwNjIzMA==,13,j_619988,10,Terminated,572074,572180,106,100,0.1
task_MzQwMDQzNjY0MzkwNzU2ODYyMg==,80,j_581292,12,Terminated,183276,183321,45,100,0.39
task_LTg0MTUwNTA5Mjg4MDkwNjIzMA==,34,j_669696,10,Terminated,658480,658510,30,100,0.1
task_LTg0MTUwNTA5Mjg4MDkwNjIzMA==,30,j_678614,10,Terminated,226496,226525,29,100,0.1
task_NzQ3MjEzNzg0MzE5NDE5NzM1Mg==,21,j_850097,3,Terminated,226549,226583,34,100,1.53
task_LTg0MTUwNTA5Mjg4MDkwNjIzMA==,11,j_259048,10,Terminated,226553,226595,42,100,0.1
task_LTg0MTUwNTA5Mjg4MDkwNjIzMA==,11,j_418050,10,Terminated,312959,312988,29,100,0.1
task_LTg0MTUwNTA5Mjg4MDkwNjIzMA==,21,j_519444,10,Terminated,507389,507409,20,100,0.1
task_LTg0MTUwNTA5Mjg4MDkwNjIzMA==,40,j_886662,10,Terminated,658602,658633,31,100,0.1
task_LTg0MTUwNTA5Mjg4MDkwNjIzMA==,11,j_680327,10,Terminated,226632,226657,25,100,0.1
task_LTg0MTUwNTA5Mjg4MDkwNjIzMA==,26,j_526158,10,Terminated,313068,313093,25,100,0.1
task_LTg0MTUwNTA5Mjg4MDkwNjIzMA==,21,j_352718,10,Terminated,572288,572311,23,100,0.1
task_LTg0MTUwNTA5Mjg4MDkwNjIzMA==,25,j_433039,10,Terminated,572289,572312,23,100,0.1
task_MzQwMDQzNjY0MzkwNzU2ODYyMg==,13,j_122801,12,Terminated,118742,118784,42,100,0.39
task_LTg0MTUwNTA5Mjg4MDkwNjIzMA==,17,j_548588,10,Terminated,572360,572382,22,100,0.1
task_LTg0MTUwNTA5Mjg4MDkwNjIzMA==,13,j_521598,10,Terminated,161966,161990,24,100,0.1
task_LTg0MTUwNTA5Mjg4MDkwNjIzMA==,20,j_7047,10,Terminated,572374,572397,23,100,0.1
task_OTg1NjA1OTIxMzA4ODkxNg==,12,j_145823,8,Terminated,442787,442868,81,100,0.78
task_LTg0MTUwNTA5Mjg4MDkwNjIzMA==,10,j_293274,10,Terminated,572402,572433,31,100,0.1
task_LTI0MjU2NDM0NTE3NDI0MzkwNjE=,66,j_748856,3,Terminated,226804,226854,50,100,0.39
task_LTg0MTUwNTA5Mjg4MDkwNjIzMA==,12,j_528714,10,Terminated,486005,486040,35,100,0.1
task_ODYzMjgxNTM3NDQ2NzUwMjQxMg==,13,j_430916,8,Terminated,464423,464487,64,100,0.59
task_OTg1NjA1OTIxMzA4ODkxNg==,11,j_56388,8,Terminated,442826,442860,34,100,0.59
task_OTg1NjA1OTIxMzA4ODkxNg==,35,j_69265,8,Terminated,205232,205278,46,100,0.59
task_ODYzMjgxNTM3NDQ2NzUwMjQxMg==,13,j_69265,8,Terminated,205232,205309,77,100,0.59
task_LTg0MTUwNTA5Mjg4MDkwNjIzMA==,12,j_809409,10,Terminated,486070,486094,24,100,0.1
task_LTg0MTUwNTA5Mjg4MDkwNjIzMA==,12,j_99821,10,Terminated,486078,486099,21,100,0.1
task_LTg0MTUwNTA5Mjg4MDkwNjIzMA==,24,j_658174,10,Terminated,658906,658936,30,100,0.1
task_MzQwMDQzNjY0MzkwNzU2ODYyMg==,34,j_490831,3,Terminated,378106,378192,86,100,0.39
task_LTI0MjU2NDM0NTE3NDI0MzkwNjE=,34,j_490831,3,Terminated,378106,378299,193,100,0.39
task_LTI0MjU2NDM0NTE3NDI0MzkwNjE=,11,j_681452,12,Terminated,97320,97373,53,100,0.39
task_LTg0MTUwNTA5Mjg4MDkwNjIzMA==,17,j_588670,10,Terminated,572537,572568,31,100,0.1
task_LTg0MTUwNTA5Mjg4MDkwNjIzMA==,17,j_706518,10,Terminated,572551,572590,39,100,0.1
task_MzQwMDQzNjY0MzkwNzU2ODYyMg==,53,j_152338,3,Terminated,615752,615784,32,100,0.39
task_LTI0MjU2NDM0NTE3NDI0MzkwNjE=,53,j_152338,3,Terminated,615752,615849,97,100,0.39
task_LTg0MTUwNTA5Mjg4MDkwNjIzMA==,24,j_131663,10,Terminated,658974,659000,26,100,0.1
task_LTg0MTUwNTA5Mjg4MDkwNjIzMA==,28,j_26061,10,Terminated,658995,659021,26,100,0.1
task_LTg0MTUwNTA5Mjg4MDkwNjIzMA==,17,j_330016,10,Terminated,572624,572654,30,100,0.1
task_LTg0MTUwNTA5Mjg4MDkwNjIzMA==,17,j_23444,10,Terminated,572627,572663,36,100,0.1
task_ODg3NTU4NTE3NDcxODA4NjA5Ng==,21,j_687499,3,Terminated,270228,270327,99,100,0.39
task_LTg0MTUwNTA5Mjg4MDkwNjIzMA==,29,j_718940,10,Terminated,507838,507859,21,100,0.1
task_LTg0MTUwNTA5Mjg4MDkwNjIzMA==,12,j_461135,10,Terminated,162239,162261,22,100,0.1
task_MzQwMDQzNjY0MzkwNzU2ODYyMg==,80,j_630390,12,Terminated,97465,97548,83,100,0.39
task_LTI0MjU2NDM0NTE3NDI0MzkwNjE=,22,j_852103,3,Terminated,443076,443115,39,100,0.39
task_LTg0MTUwNTA5Mjg4MDkwNjIzMA==,19,j_883784,10,Terminated,572681,572710,29,100,0.1
task_LTg0MTUwNTA5Mjg4MDkwNjIzMA==,22,j_437603,10,Terminated,659112,659140,28,100,0.1
task_OTg1NjA1OTIxMzA4ODkxNg==,28,j_438452,8,Terminated,399915,399992,77,100,0.59
task_LTg0MTUwNTA5Mjg4MDkwNjIzMA==,36,j_155967,8,Terminated,356716,356738,22,100,0.1
task_LTg0MTUwNTA5Mjg4MDkwNjIzMA==,39,j_44856,10,Terminated,486329,486354,25,100,0.1
task_LTI0MjU2NDM0NTE3NDI0MzkwNjE=,70,j_118821,3,Terminated,594340,594468,128,100,0.39
task_MzQwMDQzNjY0MzkwNzU2ODYyMg==,70,j_118821,3,Terminated,594340,594367,27,100,0.39
task_OTg1NjA1OTIxMzA4ODkxNg==,17,j_450186,8,Terminated,378384,378494,110,100,0.59
task_LTg0MTUwNTA5Mjg4MDkwNjIzMA==,17,j_563790,10,Terminated,572785,572821,36,100,0.1
task_LTg0MTUwNTA5Mjg4MDkwNjIzMA==,17,j_578690,10,Terminated,572790,572835,45,100,0.1
task_LTI0MjU2NDM0NTE3NDI0MzkwNjE=,20,j_800494,3,Terminated,680796,680853,57,100,0.39
task_MzQwMDQzNjY0MzkwNzU2ODYyMg==,20,j_800494,3,Terminated,680796,680827,31,100,0.39
task_LTI0MjU2NDM0NTE3NDI0MzkwNjE=,24,j_505108,3,Terminated,140817,140857,40,100,0.39
task_LTI0MjU2NDM0NTE3NDI0MzkwNjE=,100,j_628764,12,Terminated,529644,529710,66,100,0.77
task_MzQwMDQzNjY0MzkwNzU2ODYyMg==,41,j_628764,12,Terminated,529644,529675,31,100,0.77
task_ODg3NTU4NTE3NDcxODA4NjA5Ng==,40,j_137636,3,Terminated,551268,551375,107,100,0.39
task_LTg0MTUwNTA5Mjg4MDkwNjIzMA==,17,j_449591,10,Terminated,227275,227305,30,100,0.1
task_LTg0MTUwNTA5Mjg4MDkwNjIzMA==,20,j_499955,10,Terminated,572884,572930,46,100,0.1
task_MzQwMDQzNjY0MzkwNzU2ODYyMg==,20,j_15120,12,Terminated,443337,443386,49,100,0.39
task_LTg0MTUwNTA5Mjg4MDkwNjIzMA==,17,j_63139,10,Terminated,572941,572972,31,100,0.1
task_LTg0MTUwNTA5Mjg4MDkwNjIzMA==,10,j_56609,10,Terminated,572965,573017,52,100,0.1
task_LTg0MTUwNTA5Mjg4MDkwNjIzMA==,17,j_540262,10,Terminated,572966,573001,35,100,0.1
task_LTg0MTUwNTA5Mjg4MDkwNjIzMA==,39,j_862745,10,Terminated,486595,486626,31,100,0.1
task_LTI0MjU2NDM0NTE3NDI0MzkwNjE=,61,j_449087,3,Terminated,227424,227483,59,100,0.39
task_LTg0MTUwNTA5Mjg4MDkwNjIzMA==,12,j_484869,10,Terminated,573025,573065,40,100,0.1
task_LTg0MTUwNTA5Mjg4MDkwNjIzMA==,60,j_628763,10,Terminated,486643,486664,21,100,0.1
task_LTg0MTUwNTA5Mjg4MDkwNjIzMA==,23,j_726393,10,Terminated,659505,659529,24,100,0.1
task_LTg0MTUwNTA5Mjg4MDkwNjIzMA==,39,j_888150,10,Terminated,486706,486730,24,100,0.1
task_MzQwMDQzNjY0MzkwNzU2ODYyMg==,41,j_464483,12,Terminated,270727,270927,200,100,0.77
task_LTg0MTUwNTA5Mjg4MDkwNjIzMA==,12,j_798036,10,Terminated,162763,162791,28,100,0.1
task_LTg0MTUwNTA5Mjg4MDkwNjIzMA==,15,j_321874,10,Terminated,162804,162831,27,100,0.1
task_LTg0MTUwNTA5Mjg4MDkwNjIzMA==,17,j_859887,10,Terminated,573216,573237,21,100,0.1
task_LTg0MTUwNTA5Mjg4MDkwNjIzMA==,39,j_573998,10,Terminated,486830,486869,39,100,0.1
task_LTg0MTUwNTA5Mjg4MDkwNjIzMA==,12,j_516683,10,Terminated,486833,486870,37,100,0.1
task_LTg5MTI5MTc1ODQzMjE2MTczMTk=,40,j_789720,3,Terminated,422033,422148,115,100,0.79
task_LTg0MTUwNTA5Mjg4MDkwNjIzMA==,11,j_740919,10,Terminated,162835,162861,26,100,0.1
task_LTg0MTUwNTA5Mjg4MDkwNjIzMA==,22,j_812193,10,Terminated,659654,659682,28,100,0.1
task_LTg0MTUwNTA5Mjg4MDkwNjIzMA==,14,j_838507,10,Terminated,335666,335693,27,100,0.1
task_LTg0MTUwNTA5Mjg4MDkwNjIzMA==,17,j_165679,10,Terminated,573267,573293,26,100,0.1
task_LTg0MTUwNTA5Mjg4MDkwNjIzMA==,10,j_87052,10,Terminated,335670,335693,23,100,0.1
task_LTg5MTI5MTc1ODQzMjE2MTczMTk=,41,j_369747,3,Terminated,443676,443764,88,100,0.79
task_LTg5MTI5MTc1ODQzMjE2MTczMTk=,41,j_129290,3,Terminated,530089,530183,94,100,0.79
task_LTg0MTUwNTA5Mjg4MDkwNjIzMA==,17,j_716018,10,Terminated,573294,573314,20,100,0.1
task_LTg5MTI5MTc1ODQzMjE2MTczMTk=,42,j_448414,3,Terminated,292502,292588,86,100,0.79
task_ODg3NTU4NTE3NDcxODA4NjA5Ng==,17,j_170426,3,Terminated,184515,184542,27,100,0.39
task_LTg0MTUwNTA5Mjg4MDkwNjIzMA==,10,j_278282,10,Terminated,573316,573341,25,100,0.1
task_MzQwMDQzNjY0MzkwNzU2ODYyMg==,79,j_322819,3,Terminated,443743,443764,21,100,0.39
task_LTI0MjU2NDM0NTE3NDI0MzkwNjE=,79,j_322819,3,Terminated,443743,443812,69,100,0.39
task_LTg0MTUwNTA5Mjg4MDkwNjIzMA==,17,j_593957,10,Terminated,508555,508595,40,100,0.1
task_NzQ3MjEzNzg0MzE5NDE5NzM1Mg==,13,j_840383,3,Terminated,357390,357447,57,100,1.53
task_LTg0MTUwNTA5Mjg4MDkwNjIzMA==,39,j_397896,10,Terminated,487009,487037,28,100,0.1
task_LTg0MTUwNTA5Mjg4MDkwNjIzMA==,16,j_312022,10,Terminated,227833,227856,23,100,0.1
task_LTg0MTUwNTA5Mjg4MDkwNjIzMA==,84,j_695645,10,Terminated,487068,487093,25,100,0.1
task_LTg0MTUwNTA5Mjg4MDkwNjIzMA==,12,j_393422,10,Terminated,487068,487090,22,100,0.1
task_LTg0MTUwNTA5Mjg4MDkwNjIzMA==,21,j_782123,10,Terminated,141476,141496,20,100,0.1
task_LTg0MTUwNTA5Mjg4MDkwNjIzMA==,13,j_301754,10,Terminated,141516,141536,20,100,0.1
task_LTg0MTUwNTA5Mjg4MDkwNjIzMA==,12,j_50636,10,Terminated,487120,487140,20,100,0.1
task_LTg0MTUwNTA5Mjg4MDkwNjIzMA==,11,j_873043,10,Terminated,141528,141549,21,100,0.1
task_MzQwMDQzNjY0MzkwNzU2ODYyMg==,39,j_725775,3,Terminated,508736,508792,56,100,0.39
task_LTg0MTUwNTA5Mjg4MDkwNjIzMA==,11,j_884999,10,Terminated,487150,487171,21,100,0.1
task_LTg0MTUwNTA5Mjg4MDkwNjIzMA==,14,j_789876,10,Terminated,228030,228101,71,100,0.1
task_LTg0MTUwNTA5Mjg4MDkwNjIzMA==,10,j_882516,10,Terminated,228034,228091,57,100,0.1
task_LTg5MTI5MTc1ODQzMjE2MTczMTk=,31,j_623932,3,Terminated,184851,184919,68,100,0.79
task_LTg0MTUwNTA5Mjg4MDkwNjIzMA==,13,j_651582,10,Terminated,336082,336105,23,100,0.1
task_LTg0MTUwNTA5Mjg4MDkwNjIzMA==,13,j_906322,10,Terminated,336099,336119,20,100,0.1
task_LTg0MTUwNTA5Mjg4MDkwNjIzMA==,16,j_522494,10,Terminated,141713,141733,20,100,0.1
task_LTg0MTUwNTA5Mjg4MDkwNjIzMA==,13,j_145149,10,Terminated,487337,487360,23,100,0.1
task_NzQ3MjEzNzg0MzE5NDE5NzM1Mg==,11,j_119808,3,Terminated,444169,444227,58,100,1.53
task_LTg0MTUwNTA5Mjg4MDkwNjIzMA==,17,j_1165,10,Terminated,573772,573799,27,100,0.1
task_LTg0MTUwNTA5Mjg4MDkwNjIzMA==,19,j_27846,10,Terminated,573777,573799,22,100,0.1
task_LTg0MTUwNTA5Mjg4MDkwNjIzMA==,11,j_809125,10,Terminated,163378,163408,30,100,0.1
task_LTg0MTUwNTA5Mjg4MDkwNjIzMA==,10,j_397014,10,Terminated,573835,573863,28,100,0.1
task_LTg0MTUwNTA5Mjg4MDkwNjIzMA==,13,j_680625,10,Terminated,336265,336286,21,100,0.1
task_MzQwMDQzNjY0MzkwNzU2ODYyMg==,13,j_540950,12,Terminated,271494,271548,54,100,0.39
task_LTg0MTUwNTA5Mjg4MDkwNjIzMA==,17,j_415812,10,Terminated,487495,487515,20,100,0.1
task_LTcyMjgzNTU0Nzk1OTg3NTA5MzM=,20,j_821495,12,Terminated,465931,465976,45,100,1.34
task_LTEyMjkyMzM5NDA0NjY2NzEwMzY=,20,j_821495,12,Terminated,465931,465984,53,100,0.96
task_LTg0MTUwNTA5Mjg4MDkwNjIzMA==,20,j_99955,10,Terminated,141966,141991,25,100,0.1
task_MzQwMDQzNjY0MzkwNzU2ODYyMg==,70,j_846807,3,Terminated,142036,142061,25,100,0.39
task_LTI0MjU2NDM0NTE3NDI0MzkwNjE=,70,j_846807,3,Terminated,142036,142098,62,100,0.39
task_LTg0MTUwNTA5Mjg4MDkwNjIzMA==,19,j_138064,10,Terminated,574039,574060,21,100,0.1
task_LTg0MTUwNTA5Mjg4MDkwNjIzMA==,24,j_858685,10,Terminated,487680,487718,38,100,0.1
task_LTg0MTUwNTA5Mjg4MDkwNjIzMA==,64,j_743843,10,Terminated,487687,487711,24,100,0.1
task_LTg0MTUwNTA5Mjg4MDkwNjIzMA==,12,j_380918,10,Terminated,163738,163760,22,100,0.1
task_LTg0MTUwNTA5Mjg4MDkwNjIzMA==,27,j_687202,8,Terminated,379744,379765,21,100,0.1
task_LTg0MTUwNTA5Mjg4MDkwNjIzMA==,18,j_707212,10,Terminated,314954,314979,25,100,0.1
task_LTI0MjU2NDM0NTE3NDI0MzkwNjE=,10,j_47230,3,Terminated,638964,638985,21,100,0.39
task_LTI0MjU2NDM0NTE3NDI0MzkwNjE=,44,j_845704,3,Terminated,638969,639008,39,100,0.39
task_LTg0MTUwNTA5Mjg4MDkwNjIzMA==,10,j_334969,10,Terminated,574186,574214,28,100,0.1
task_LTg0MTUwNTA5Mjg4MDkwNjIzMA==,19,j_831991,10,Terminated,574191,574220,29,100,0.1
task_ODYzMjgxNTM3NDQ2NzUwMjQxMg==,13,j_653265,8,Terminated,120617,120674,57,100,0.59
task_OTg1NjA1OTIxMzA4ODkxNg==,37,j_653265,8,Terminated,120617,120651,34,100,0.59
task_ODYzMjgxNTM3NDQ2NzUwMjQxMg==,21,j_182817,8,Terminated,142218,142262,44,100,0.59
task_ODYzMjgxNTM3NDQ2NzUwMjQxMg==,29,j_904887,8,Terminated,682219,682245,26,100,0.59
task_ODYzMjgxNTM3NDQ2NzUwMjQxMg==,13,j_696623,8,Terminated,207020,207084,64,100,0.59
task_OTg1NjA1OTIxMzA4ODkxNg==,13,j_620123,8,Terminated,185461,185481,20,100,0.59
task_LTg0MTUwNTA5Mjg4MDkwNjIzMA==,77,j_731218,10,Terminated,487893,487921,28,100,0.1
task_LTg0MTUwNTA5Mjg4MDkwNjIzMA==,20,j_96694,10,Terminated,142334,142361,27,100,0.1
task_LTI0MjU2NDM0NTE3NDI0MzkwNjE=,37,j_616523,3,Terminated,639186,639222,36,100,0.39
task_LTg0MTUwNTA5Mjg4MDkwNjIzMA==,18,j_342193,10,Terminated,574494,574526,32,100,0.1
task_LTg0MTUwNTA5Mjg4MDkwNjIzMA==,23,j_541864,10,Terminated,488182,488204,22,100,0.1
task_LTg0MTUwNTA5Mjg4MDkwNjIzMA==,61,j_214618,10,Terminated,488212,488242,30,100,0.1
task_LTg0MTUwNTA5Mjg4MDkwNjIzMA==,14,j_305490,10,Terminated,315426,315459,33,100,0.1
task_LTg0MTUwNTA5Mjg4MDkwNjIzMA==,16,j_242639,10,Terminated,337047,337091,44,100,0.1
task_LTg0MTUwNTA5Mjg4MDkwNjIzMA==,19,j_3571,10,Terminated,142692,142716,24,100,0.1
task_LTI0MjU2NDM0NTE3NDI0MzkwNjE=,35,j_521789,3,Terminated,661094,661159,65,100,0.39
task_MzQwMDQzNjY0MzkwNzU2ODYyMg==,35,j_521789,3,Terminated,661094,661117,23,100,0.39
task_MzQwMDQzNjY0MzkwNzU2ODYyMg==,41,j_626097,3,Terminated,661098,661118,20,100,0.39
task_LTI0MjU2NDM0NTE3NDI0MzkwNjE=,41,j_626097,3,Terminated,661098,661177,79,100,0.39
task_LTg0MTUwNTA5Mjg4MDkwNjIzMA==,11,j_480431,10,Terminated,229121,229152,31,100,0.1
task_LTg5MTI5MTc1ODQzMjE2MTczMTk=,61,j_333214,3,Terminated,445143,445208,65,100,0.79
task_LTg0MTUwNTA5Mjg4MDkwNjIzMA==,27,j_343149,10,Terminated,488349,488369,20,100,0.1
task_LTg0MTUwNTA5Mjg4MDkwNjIzMA==,16,j_739127,10,Terminated,229189,229210,21,100,0.1
task_LTg0MTUwNTA5Mjg4MDkwNjIzMA==,23,j_635428,10,Terminated,315600,315623,23,100,0.1
task_LTg0MTUwNTA5Mjg4MDkwNjIzMA==,18,j_590957,10,Terminated,142810,142837,27,100,0.1
task_LTg0MTUwNTA5Mjg4MDkwNjIzMA==,23,j_661793,10,Terminated,142841,142865,24,100,0.1
task_ODg3NTU4NTE3NDcxODA4NjA5Ng==,79,j_397496,3,Terminated,207706,207785,79,100,0.39
task_LTg0MTUwNTA5Mjg4MDkwNjIzMA==,22,j_569430,10,Terminated,142919,142939,20,100,0.1
task_LTg0MTUwNTA5Mjg4MDkwNjIzMA==,13,j_488424,10,Terminated,229363,229388,25,100,0.1
task_LTg0MTUwNTA5Mjg4MDkwNjIzMA==,59,j_368137,10,Terminated,488616,488638,22,100,0.1
task_LTg0MTUwNTA5Mjg4MDkwNjIzMA==,16,j_38191,10,Terminated,229422,229453,31,100,0.1
task_MzQwMDQzNjY0MzkwNzU2ODYyMg==,18,j_353018,12,Terminated,99951,100057,106,100,0.39
task_LTg0MTUwNTA5Mjg4MDkwNjIzMA==,26,j_74089,10,Terminated,488782,488818,36,100,0.1
task_LTg0MTUwNTA5Mjg4MDkwNjIzMA==,21,j_676527,8,Terminated,100109,100146,37,100,0.1
task_LTEwOTY0ODA4MjU3NTE0MjIwNTA=,40,j_794382,12,Terminated,100141,100170,29,100,0.96
task_LTEyMjkyMzM5NDA0NjY2NzEwMzY=,40,j_794382,12,Terminated,100141,100191,50,100,0.96
task_LTcyMjgzNTU0Nzk1OTg3NTA5MzM=,40,j_794382,12,Terminated,100141,100185,44,100,1.34
task_LTg0MTUwNTA5Mjg4MDkwNjIzMA==,18,j_195353,10,Terminated,143350,143371,21,100,0.1
task_LTI0MjU2NDM0NTE3NDI0MzkwNjE=,94,j_697780,3,Terminated,294550,294614,64,100,0.39
task_MzQwMDQzNjY0MzkwNzU2ODYyMg==,10,j_504068,12,Terminated,618573,618732,159,100,0.39
task_LTg0MTUwNTA5Mjg4MDkwNjIzMA==,12,j_852853,10,Terminated,337778,337801,23,100,0.1
task_MzQwMDQzNjY0MzkwNzU2ODYyMg==,50,j_169035,12,Terminated,100215,100245,30,100,0.39
task_LTg0MTUwNTA5Mjg4MDkwNjIzMA==,15,j_811984,10,Terminated,489028,489069,41,100,0.1
task_LTg0MTUwNTA5Mjg4MDkwNjIzMA==,17,j_294485,10,Terminated,143456,143479,23,100,0.1
task_MzQwMDQzNjY0MzkwNzU2ODYyMg==,20,j_389502,12,Terminated,273093,273192,99,100,0.39
task_LTg0MTUwNTA5Mjg4MDkwNjIzMA==,15,j_442784,10,Terminated,143529,143563,34,100,0.1
task_LTg0MTUwNTA5Mjg4MDkwNjIzMA==,15,j_563297,10,Terminated,337967,338037,70,100,0.1
task_LTg0MTUwNTA5Mjg4MDkwNjIzMA==,11,j_206369,10,Terminated,230031,230070,39,100,0.1
task_LTg0MTUwNTA5Mjg4MDkwNjIzMA==,15,j_387400,10,Terminated,510897,510924,27,100,0.1
task_LTg0MTUwNTA5Mjg4MDkwNjIzMA==,24,j_177986,10,Terminated,230117,230139,22,100,0.1
task_LTg0MTUwNTA5Mjg4MDkwNjIzMA==,10,j_674538,8,Terminated,446125,446158,33,100,0.1
task_LTg0MTUwNTA5Mjg4MDkwNjIzMA==,56,j_589103,10,Terminated,489406,489428,22,100,0.1
task_LTg0MTUwNTA5Mjg4MDkwNjIzMA==,18,j_707323,10,Terminated,143857,143877,20,100,0.1
task_OTg1NjA1OTIxMzA4ODkxNg==,22,j_628858,8,Terminated,683867,684017,150,100,0.59
task_LTg0MTUwNTA5Mjg4MDkwNjIzMA==,17,j_667749,10,Terminated,143910,143937,27,100,0.1
task_LTg0MTUwNTA5Mjg4MDkwNjIzMA==,17,j_381775,10,Terminated,683955,683985,30,100,0.1
task_LTg0MTUwNTA5Mjg4MDkwNjIzMA==,13,j_812155,10,Terminated,338357,338384,27,100,0.1
task_NzQ3MjEzNzg0MzE5NDE5NzM1Mg==,12,j_94623,3,Terminated,273583,273631,48,100,1.53
task_LTg0MTUwNTA5Mjg4MDkwNjIzMA==,12,j_489706,10,Terminated,316786,316814,28,100,0.1
task_OTg1NjA1OTIxMzA4ODkxNg==,10,j_325294,8,Terminated,295189,295310,121,100,0.78
task_OTg1NjA1OTIxMzA4ODkxNg==,12,j_799205,8,Terminated,468020,468111,91,100,0.78
task_OTg1NjA1OTIxMzA4ODkxNg==,15,j_712921,8,Terminated,532822,532843,21,100,0.59
task_OTg1NjA1OTIxMzA4ODkxNg==,63,j_402678,8,Terminated,489622,489648,26,100,0.59
task_ODYzMjgxNTM3NDQ2NzUwMjQxMg==,23,j_402678,8,Terminated,489622,489671,49,100,0.59
task_ODYzMjgxNTM3NDQ2NzUwMjQxMg==,23,j_459362,8,Terminated,316823,316844,21,100,0.59
task_ODYzMjgxNTM3NDQ2NzUwMjQxMg==,31,j_8698,8,Terminated,597625,597679,54,100,0.59
task_OTg1NjA1OTIxMzA4ODkxNg==,87,j_8698,8,Terminated,597625,597655,30,100,0.59
task_OTg1NjA1OTIxMzA4ODkxNg==,15,j_794623,8,Terminated,360026,360069,43,100,0.59
task_ODYzMjgxNTM3NDQ2NzUwMjQxMg==,15,j_59322,8,Terminated,468028,468050,22,100,0.59
task_ODYzMjgxNTM3NDQ2NzUwMjQxMg==,23,j_556862,8,Terminated,230431,230458,27,100,0.59
task_OTg1NjA1OTIxMzA4ODkxNg==,15,j_898619,8,Terminated,619231,619268,37,100,0.59
task_OTg1NjA1OTIxMzA4ODkxNg==,15,j_460631,8,Terminated,619237,619263,26,100,0.59
task_OTg1NjA1OTIxMzA4ODkxNg==,96,j_774828,8,Terminated,489673,489860,187,100,0.59
task_MzQwMDQzNjY0MzkwNzU2ODYyMg==,50,j_327635,12,Terminated,187281,187309,28,100,0.39
task_LTg0MTUwNTA5Mjg4MDkwNjIzMA==,14,j_203591,10,Terminated,338490,338519,29,100,0.1
task_LTg0MTUwNTA5Mjg4MDkwNjIzMA==,22,j_898593,10,Terminated,230500,230524,24,100,0.1
task_ODg3NTU4NTE3NDcxODA4NjA5Ng==,46,j_819061,3,Terminated,187361,187415,54,100,0.39
task_NzQ3MjEzNzg0MzE5NDE5NzM1Mg==,26,j_710351,3,Terminated,532981,533024,43,100,1.53
task_LTg0MTUwNTA5Mjg4MDkwNjIzMA==,19,j_770549,10,Terminated,144227,144323,96,100,0.1
task_MzQwMDQzNjY0MzkwNzU2ODYyMg==,19,j_89320,12,Terminated,446656,446701,45,100,0.39
task_LTcyMjgzNTU0Nzk1OTg3NTA5MzM=,40,j_531068,12,Terminated,446660,446696,36,100,1.34
task_LTEyMjkyMzM5NDA0NjY2NzEwMzY=,40,j_531068,12,Terminated,446660,446702,42,100,0.96
task_LTg0MTUwNTA5Mjg4MDkwNjIzMA==,11,j_181267,10,Terminated,489877,489899,22,100,0.1
task_LTI0MjU2NDM0NTE3NDI0MzkwNjE=,99,j_523878,3,Terminated,641102,641160,58,100,0.39
task_LTg0MTUwNTA5Mjg4MDkwNjIzMA==,10,j_460033,8,Terminated,360310,360369,59,100,0.1
task_OTg1NjA1OTIxMzA4ODkxNg==,36,j_542936,8,Terminated,511515,511583,68,100,0.59
task_OTg1NjA1OTIxMzA4ODkxNg==,28,j_391658,8,Terminated,403527,403602,75,100,0.59
task_LTg0MTUwNTA5Mjg4MDkwNjIzMA==,11,j_397650,10,Terminated,230759,230780,21,100,0.1
task_LTg0MTUwNTA5Mjg4MDkwNjIzMA==,19,j_24075,10,Terminated,662830,662881,51,100,0.1
task_LTg0MTUwNTA5Mjg4MDkwNjIzMA==,18,j_825100,10,Terminated,230837,230859,22,100,0.1
task_LTg0MTUwNTA5Mjg4MDkwNjIzMA==,17,j_537393,10,Terminated,662885,662910,25,100,0.1
task_NzQ3MjEzNzg0MzE5NDE5NzM1Mg==,38,j_603389,3,Terminated,533361,533406,45,100,1.53
task_LTg0MTUwNTA5Mjg4MDkwNjIzMA==,14,j_137891,10,Terminated,511767,511787,20,100,0.1
task_LTg0MTUwNTA5Mjg4MDkwNjIzMA==,52,j_795545,10,Terminated,490175,490199,24,100,0.1
task_LTg0MTUwNTA5Mjg4MDkwNjIzMA==,22,j_467051,10,Terminated,144608,144667,59,100,0.1
task_LTcyMjgzNTU0Nzk1OTg3NTA5MzM=,25,j_379219,12,Terminated,360612,360651,39,100,1.34
task_LTEyMjkyMzM5NDA0NjY2NzEwMzY=,25,j_379219,12,Terminated,360613,360659,46,100,0.96
task_LTEwOTY0ODA4MjU3NTE0MjIwNTA=,25,j_379219,12,Terminated,360614,360636,22,100,0.96
task_ODYzMjgxNTM3NDQ2NzUwMjQxMg==,13,j_725061,8,Terminated,317430,317476,46,100,0.59
task_OTg1NjA1OTIxMzA4ODkxNg==,36,j_725061,8,Terminated,317430,317470,40,100,0.59
task_LTg0MTUwNTA5Mjg4MDkwNjIzMA==,32,j_19706,10,Terminated,317595,317644,49,100,0.1
task_LTg5MTI5MTc1ODQzMjE2MTczMTk=,40,j_417016,3,Terminated,512021,512119,98,100,0.79
task_LTg5MTI5MTc1ODQzMjE2MTczMTk=,43,j_87721,3,Terminated,490423,490591,168,100,0.79
task_LTg5MTI5MTc1ODQzMjE2MTczMTk=,43,j_385892,3,Terminated,576833,577006,173,100,0.79
task_LTg0MTUwNTA5Mjg4MDkwNjIzMA==,11,j_13056,10,Terminated,231245,231265,20,100,0.1
task_LTI0MjU2NDM0NTE3NDI0MzkwNjE=,59,j_468074,3,Terminated,231254,231299,45,100,0.39
task_LTI0MjU2NDM0NTE3NDI0MzkwNjE=,59,j_441402,3,Terminated,231255,231292,37,100,0.39
task_LTg0MTUwNTA5Mjg4MDkwNjIzMA==,28,j_876145,8,Terminated,209667,209696,29,100,0.1
task_MzQwMDQzNjY0MzkwNzU2ODYyMg==,11,j_766347,12,Terminated,274477,274513,36,100,0.39
task_LTI0MjU2NDM0NTE3NDI0MzkwNjE=,11,j_766347,12,Terminated,274477,274615,138,100,0.39
task_LTI0MjU2NDM0NTE3NDI0MzkwNjE=,65,j_609273,3,Terminated,231282,231326,44,100,0.39
task_LTg0MTUwNTA5Mjg4MDkwNjIzMA==,10,j_862366,10,Terminated,663285,663319,34,100,0.1
task_LTg0MTUwNTA5Mjg4MDkwNjIzMA==,13,j_660714,10,Terminated,490486,490510,24,100,0.1
task_LTI0MjU2NDM0NTE3NDI0MzkwNjE=,59,j_99355,3,Terminated,231291,231329,38,100,0.39
task_LTI0MjU2NDM0NTE3NDI0MzkwNjE=,60,j_54305,3,Terminated,231303,231338,35,100,0.39
task_MzQwMDQzNjY0MzkwNzU2ODYyMg==,12,j_582012,12,Terminated,620103,620149,46,100,0.39
task_MzQwMDQzNjY0MzkwNzU2ODYyMg==,70,j_4609,3,Terminated,231310,231331,21,100,0.39
task_LTI0MjU2NDM0NTE3NDI0MzkwNjE=,70,j_4609,3,Terminated,231310,231364,54,100,0.39
task_LTI0MjU2NDM0NTE3NDI0MzkwNjE=,68,j_611030,3,Terminated,231315,231356,41,100,0.39
task_LTI0MjU2NDM0NTE3NDI0MzkwNjE=,51,j_589283,12,Terminated,620141,620170,29,100,0.1
task_LTI0MjU2NDM0NTE3NDI0MzkwNjE=,66,j_65766,3,Terminated,231341,231382,41,100,0.39
task_MzQwMDQzNjY0MzkwNzU2ODYyMg==,51,j_589283,12,Terminated,620142,620164,22,100,0.19
task_LTMwODg1Nzc1MDM3OTcxODM2NjA=,58,j_144000,3,Terminated,188151,188221,70,100,0.39
task_LTEwOTY0ODA4MjU3NTE0MjIwNTA=,58,j_144000,3,Terminated,188151,188185,34,100,0.39
task_LTcyMjgzNTU0Nzk1OTg3NTA5MzM=,58,j_144000,3,Terminated,188152,188205,53,100,0.39
task_MzQwMDQzNjY0MzkwNzU2ODYyMg==,18,j_583436,12,Terminated,360965,361042,77,100,0.39
task_LTI0MjU2NDM0NTE3NDI0MzkwNjE=,18,j_583436,12,Terminated,360965,361151,186,100,0.39
task_LTg0MTUwNTA5Mjg4MDkwNjIzMA==,13,j_857268,10,Terminated,144974,145031,57,100,0.1
task_LTI0MjU2NDM0NTE3NDI0MzkwNjE=,70,j_358019,3,Terminated,231379,231419,40,100,0.39
task_LTI0MjU2NDM0NTE3NDI0MzkwNjE=,68,j_14261,3,Terminated,231380,231425,45,100,0.39
task_LTg0MTUwNTA5Mjg4MDkwNjIzMA==,13,j_201756,10,Terminated,317780,317800,20,100,0.1
task_LTg0MTUwNTA5Mjg4MDkwNjIzMA==,17,j_697278,10,Terminated,231394,231420,26,100,0.1
task_LTI0MjU2NDM0NTE3NDI0MzkwNjE=,60,j_448955,3,Terminated,231404,231442,38,100,0.39
task_LTg0MTUwNTA5Mjg4MDkwNjIzMA==,22,j_116685,10,Terminated,231421,231451,30,100,0.1
task_LTg5MTI5MTc1ODQzMjE2MTczMTk=,40,j_97951,3,Terminated,425821,425918,97,100,0.79
task_LTI0MjU2NDM0NTE3NDI0MzkwNjE=,17,j_357235,3,Terminated,123445,123480,35,100,0.39
task_LTI0MjU2NDM0NTE3NDI0MzkwNjE=,60,j_242223,3,Terminated,231450,231493,43,100,0.39
task_MzQwMDQzNjY0MzkwNzU2ODYyMg==,83,j_824641,12,Terminated,620258,620391,133,100,0.39
task_ODg3NTU4NTE3NDcxODA4NjA5Ng==,46,j_529293,3,Terminated,469058,469096,38,100,0.39
task_MzQwMDQzNjY0MzkwNzU2ODYyMg==,25,j_428118,3,Terminated,145066,145098,32,100,0.39
task_LTI0MjU2NDM0NTE3NDI0MzkwNjE=,25,j_428118,3,Terminated,145066,145122,56,100,0.39
task_LTI0MjU2NDM0NTE3NDI0MzkwNjE=,59,j_539257,3,Terminated,231472,231514,42,100,0.39
task_LTI0MjU2NDM0NTE3NDI0MzkwNjE=,22,j_468942,3,Terminated,577120,577153,33,100,0.39
task_LTI0MjU2NDM0NTE3NDI0MzkwNjE=,100,j_853555,3,Terminated,296376,296431,55,100,0.77
task_MzQwMDQzNjY0MzkwNzU2ODYyMg==,29,j_853555,3,Terminated,296377,296398,21,100,0.77
task_LTg0MTUwNTA5Mjg4MDkwNjIzMA==,19,j_645830,10,Terminated,317981,318008,27,100,0.1
task_MzQwMDQzNjY0MzkwNzU2ODYyMg==,51,j_801770,12,Terminated,469188,469212,24,100,0.39
task_LTg0MTUwNTA5Mjg4MDkwNjIzMA==,18,j_463995,10,Terminated,145191,145298,107,100,0.1
task_LTg0MTUwNTA5Mjg4MDkwNjIzMA==,17,j_428168,10,Terminated,231596,231621,25,100,0.1
task_LTg0MTUwNTA5Mjg4MDkwNjIzMA==,17,j_602129,10,Terminated,231622,231644,22,100,0.1
task_MzQwMDQzNjY0MzkwNzU2ODYyMg==,35,j_353066,3,Terminated,663633,663654,21,100,0.39
task_LTI0MjU2NDM0NTE3NDI0MzkwNjE=,35,j_353066,3,Terminated,663633,663682,49,100,0.39
task_MzQwMDQzNjY0MzkwNzU2ODYyMg==,20,j_332107,3,Terminated,318055,318086,31,100,0.39
task_LTI0MjU2NDM0NTE3NDI0MzkwNjE=,20,j_332107,3,Terminated,318055,318110,55,100,0.39
task_LTg0MTUwNTA5Mjg4MDkwNjIzMA==,17,j_27346,10,Terminated,231660,231713,53,100,0.1
task_MzQwMDQzNjY0MzkwNzU2ODYyMg==,11,j_234600,12,Terminated,361261,361296,35,100,0.39
task_LTI0MjU2NDM0NTE3NDI0MzkwNjE=,11,j_234600,12,Terminated,361261,361396,135,100,0.39
task_LTg0MTUwNTA5Mjg4MDkwNjIzMA==,10,j_304235,10,Terminated,490878,490902,24,100,0.1
task_LTI0MjU2NDM0NTE3NDI0MzkwNjE=,10,j_257534,12,Terminated,188479,188677,198,100,0.39
task_MzQwMDQzNjY0MzkwNzU2ODYyMg==,10,j_257534,12,Terminated,188479,188578,99,100,0.39
task_MzQwMDQzNjY0MzkwNzU2ODYyMg==,25,j_357843,12,Terminated,188485,188594,109,100,0.39
task_LTg0MTUwNTA5Mjg4MDkwNjIzMA==,37,j_517857,10,Terminated,490894,490925,31,100,0.1
task_LTg0MTUwNTA5Mjg4MDkwNjIzMA==,17,j_486785,10,Terminated,231699,231735,36,100,0.1
task_LTI0MjU2NDM0NTE3NDI0MzkwNjE=,10,j_267988,12,Terminated,274930,274985,55,100,0.39
task_LTg0MTUwNTA5Mjg4MDkwNjIzMA==,34,j_154907,10,Terminated,490931,490952,21,100,0.1
task_LTI0MjU2NDM0NTE3NDI0MzkwNjE=,20,j_118413,3,Terminated,577338,577371,33,100,0.39
task_LTI0MjU2NDM0NTE3NDI0MzkwNjE=,18,j_472718,3,Terminated,167002,167041,39,100,0.39
task_LTg0MTUwNTA5Mjg4MDkwNjIzMA==,12,j_134905,10,Terminated,318219,318252,33,100,0.1
task_LTI0MjU2NDM0NTE3NDI0MzkwNjE=,23,j_256029,3,Terminated,512647,512687,40,100,0.39
task_LTI0MjU2NDM0NTE3NDI0MzkwNjE=,21,j_796377,3,Terminated,620648,620687,39,100,0.39
task_LTI0MjU2NDM0NTE3NDI0MzkwNjE=,39,j_329402,3,Terminated,642263,642337,74,100,0.39
task_LTI0MjU2NDM0NTE3NDI0MzkwNjE=,21,j_91711,3,Terminated,577499,577531,32,100,0.39
task_LTg0MTUwNTA5Mjg4MDkwNjIzMA==,40,j_230696,10,Terminated,663919,663941,22,100,0.1
task_ODg3NTU4NTE3NDcxODA4NjA5Ng==,40,j_816606,3,Terminated,447932,448004,72,100,0.39
task_LTI0MjU2NDM0NTE3NDI0MzkwNjE=,22,j_696146,3,Terminated,555988,556024,36,100,0.39
task_NzQ3MjEzNzg0MzE5NDE5NzM1Mg==,20,j_188078,3,Terminated,469593,469647,54,100,1.53
task_MjA0NDk5ODc0NDc1NzAwMzc3Mw==,52,j_29661,3,Terminated,620821,620949,128,100,0.2
task_OTg1NjA1OTIxMzA4ODkxNg==,83,j_458297,8,Terminated,599261,599435,174,100,0.59
task_OTg1NjA1OTIxMzA4ODkxNg==,15,j_377068,8,Terminated,167262,167420,158,100,0.59
task_LTg0MTUwNTA5Mjg4MDkwNjIzMA==,23,j_797372,10,Terminated,318471,318507,36,100,0.1
task_LTEyMjkyMzM5NDA0NjY2NzEwMzY=,35,j_90607,12,Terminated,534475,534505,30,100,0.96
task_LTcyMjgzNTU0Nzk1OTg3NTA5MzM=,35,j_90607,12,Terminated,534475,534502,27,100,1.34
task_LTEyMjkyMzM5NDA0NjY2NzEwMzY=,10,j_660582,12,Terminated,448086,448172,86,100,0.96
task_LTEwOTY0ODA4MjU3NTE0MjIwNTA=,10,j_660582,12,Terminated,448086,448164,78,100,0.96
task_LTcyMjgzNTU0Nzk1OTg3NTA5MzM=,10,j_660582,12,Terminated,448087,448169,82,100,1.34
task_ODg3NTU4NTE3NDcxODA4NjA5Ng==,21,j_282889,3,Terminated,145688,145782,94,100,0.39
task_MzQwMDQzNjY0MzkwNzU2ODYyMg==,13,j_428081,3,Terminated,469689,469755,66,100,0.32
task_LTg0MTUwNTA5Mjg4MDkwNjIzMA==,14,j_887454,10,Terminated,318489,318515,26,100,0.1
task_MzQwMDQzNjY0MzkwNzU2ODYyMg==,14,j_580941,3,Terminated,469694,469761,67,100,0.32
task_MzQwMDQzNjY0MzkwNzU2ODYyMg==,14,j_685772,3,Terminated,469695,469761,66,100,0.32
task_ODg3NTU4NTE3NDcxODA4NjA5Ng==,43,j_36407,3,Terminated,210501,210656,155,100,0.39
task_ODg3NTU4NTE3NDcxODA4NjA5Ng==,40,j_329831,3,Terminated,275364,275398,34,100,0.39
task_NzQ3MjEzNzg0MzE5NDE5NzM1Mg==,25,j_412503,3,Terminated,448171,448192,21,100,1.53
task_LTg0MTUwNTA5Mjg4MDkwNjIzMA==,20,j_758748,10,Terminated,318578,318607,29,100,0.1
task_LTEyMjkyMzM5NDA0NjY2NzEwMzY=,65,j_515297,12,Terminated,448183,448219,36,100,0.96
task_LTcyMjgzNTU0Nzk1OTg3NTA5MzM=,65,j_515297,12,Terminated,448183,448209,26,100,1.34
task_ODg3NTU4NTE3NDcxODA4NjA5Ng==,40,j_374475,3,Terminated,534616,534640,24,100,0.39
task_MjA0NDk5ODc0NDc1NzAwMzc3Mw==,52,j_554165,3,Terminated,361819,361941,122,100,0.2
task_ODYzMjgxNTM3NDQ2NzUwMjQxMg==,23,j_445976,8,Terminated,405022,405064,42,100,0.59
task_ODYzMjgxNTM3NDQ2NzUwMjQxMg==,23,j_122757,8,Terminated,664224,664284,60,100,0.59
task_OTg1NjA1OTIxMzA4ODkxNg==,65,j_122757,8,Terminated,664224,664255,31,100,0.59
task_LTg0MTUwNTA5Mjg4MDkwNjIzMA==,10,j_715685,10,Terminated,318633,318672,39,100,0.1
task_OTg1NjA1OTIxMzA4ODkxNg==,17,j_248791,8,Terminated,102638,102667,29,100,0.59
task_LTg0MTUwNTA5Mjg4MDkwNjIzMA==,25,j_821674,10,Terminated,318640,318689,49,100,0.1
task_LTcyMjgzNTU0Nzk1OTg3NTA5MzM=,35,j_329319,12,Terminated,448246,448289,43,100,1.34
task_LTEwOTY0ODA4MjU3NTE0MjIwNTA=,35,j_329319,12,Terminated,448246,448277,31,100,0.96
task_LTEyMjkyMzM5NDA0NjY2NzEwMzY=,35,j_329319,12,Terminated,448247,448295,48,100,0.96
task_LTI0MjU2NDM0NTE3NDI0MzkwNjE=,53,j_107152,12,Terminated,275473,275502,29,100,0.1
task_LTEyMjkyMzM5NDA0NjY2NzEwMzY=,40,j_555096,12,Terminated,621074,621106,32,100,0.96
task_LTcyMjgzNTU0Nzk1OTg3NTA5MzM=,40,j_555096,12,Terminated,621074,621100,26,100,1.34
task_MzQwMDQzNjY0MzkwNzU2ODYyMg==,53,j_107152,12,Terminated,275474,275496,22,100,0.19
task_LTEyMjkyMzM5NDA0NjY2NzEwMzY=,45,j_814947,12,Terminated,102723,102759,36,100,0.96
task_LTcyMjgzNTU0Nzk1OTg3NTA5MzM=,45,j_814947,12,Terminated,102723,102747,24,100,1.34
task_MzQwMDQzNjY0MzkwNzU2ODYyMg==,16,j_63924,3,Terminated,448352,448423,71,100,0.39
task_LTI0MjU2NDM0NTE3NDI0MzkwNjE=,100,j_327808,3,Terminated,297168,297262,94,100,0.77
task_MzQwMDQzNjY0MzkwNzU2ODYyMg==,53,j_327808,3,Terminated,297168,297228,60,100,0.77
task_LTI0MjU2NDM0NTE3NDI0MzkwNjE=,56,j_40701,3,Terminated,642874,642961,87,100,0.39
task_MzQwMDQzNjY0MzkwNzU2ODYyMg==,12,j_457242,12,Terminated,362080,362122,42,100,0.39
task_LTI0MjU2NDM0NTE3NDI0MzkwNjE=,12,j_457242,12,Terminated,362082,362275,193,100,0.39
task_LTI0MjU2NDM0NTE3NDI0MzkwNjE=,19,j_52897,3,Terminated,383699,383739,40,100,0.39
task_LTg0MTUwNTA5Mjg4MDkwNjIzMA==,11,j_32078,10,Terminated,578115,578139,24,100,0.1
task_LTg0MTUwNTA5Mjg4MDkwNjIzMA==,40,j_266261,10,Terminated,491724,491746,22,100,0.1
task_LTcyMjgzNTU0Nzk1OTg3NTA5MzM=,10,j_185073,12,Terminated,621335,621358,23,100,1.34
task_LTEyMjkyMzM5NDA0NjY2NzEwMzY=,10,j_185073,12,Terminated,621335,621362,27,100,0.96
task_LTg0MTUwNTA5Mjg4MDkwNjIzMA==,11,j_795345,10,Terminated,578147,578170,23,100,0.1
task_MzQwMDQzNjY0MzkwNzU2ODYyMg==,19,j_830124,12,Terminated,102953,102989,36,100,0.39
task_LTg0MTUwNTA5Mjg4MDkwNjIzMA==,13,j_47061,10,Terminated,578168,578190,22,100,0.1
task_LTI0MjU2NDM0NTE3NDI0MzkwNjE=,26,j_515400,3,Terminated,470178,470219,41,100,0.39
task_LTI0MjU2NDM0NTE3NDI0MzkwNjE=,13,j_659829,3,Terminated,297407,297453,46,100,0.39
task_LTI0MjU2NDM0NTE3NDI0MzkwNjE=,13,j_639893,3,Terminated,297416,297445,29,100,0.39
task_LTg0MTUwNTA5Mjg4MDkwNjIzMA==,20,j_24673,8,Terminated,448630,448666,36,100,0.1
task_LTcyMjgzNTU0Nzk1OTg3NTA5MzM=,10,j_101956,12,Terminated,535060,535082,22,100,1.34
task_LTEyMjkyMzM5NDA0NjY2NzEwMzY=,10,j_101956,12,Terminated,535060,535088,28,100,0.96
task_LTE3Nzc5Mzc0NTEyODIyMTQwNTc=,30,j_666905,3,Terminated,124682,124746,64,100,0.39
task_MTY3NzU4MzIxMzMzNDg4OTMzOQ==,30,j_666905,3,Terminated,124682,124758,76,100,0.39
task_LTg0MTUwNTA5Mjg4MDkwNjIzMA==,48,j_649593,10,Terminated,491882,491902,20,100,0.1
task_Mjc5MzA3NTE4MTEyMDI2MTQ2OQ==,30,j_666905,3,Terminated,124682,124796,114,100,0.39
task_OTg1NjA1OTIxMzA4ODkxNg==,26,j_238143,8,Terminated,167956,168121,165,100,0.59
task_OTg1NjA1OTIxMzA4ODkxNg==,24,j_619307,8,Terminated,513575,513769,194,100,0.59
task_LTcyMjgzNTU0Nzk1OTg3NTA5MzM=,95,j_206607,12,Terminated,448786,448808,22,100,1.34
task_LTEyMjkyMzM5NDA0NjY2NzEwMzY=,95,j_206607,12,Terminated,448786,448811,25,100,0.96
task_LTEyMjkyMzM5NDA0NjY2NzEwMzY=,45,j_480654,12,Terminated,362388,362433,45,100,0.96
task_LTEwOTY0ODA4MjU3NTE0MjIwNTA=,45,j_480654,12,Terminated,362389,362417,28,100,0.96
task_LTcyMjgzNTU0Nzk1OTg3NTA5MzM=,45,j_480654,12,Terminated,362392,362426,34,100,1.34
task_LTg0MTUwNTA5Mjg4MDkwNjIzMA==,11,j_542803,10,Terminated,578433,578460,27,100,0.1
task_MzQwMDQzNjY0MzkwNzU2ODYyMg==,16,j_108978,3,Terminated,362435,362502,67,100,0.39
task_LTg0MTUwNTA5Mjg4MDkwNjIzMA==,13,j_733987,10,Terminated,578445,578470,25,100,0.1
task_LTg0MTUwNTA5Mjg4MDkwNjIzMA==,39,j_563527,10,Terminated,492049,492071,22,100,0.1
task_LTg0MTUwNTA5Mjg4MDkwNjIzMA==,22,j_298132,10,Terminated,319258,319278,20,100,0.1
task_MzQwMDQzNjY0MzkwNzU2ODYyMg==,33,j_773323,3,Terminated,621672,621755,83,100,0.39
task_MzQwMDQzNjY0MzkwNzU2ODYyMg==,35,j_905196,3,Terminated,643275,643308,33,100,0.19
task_LTI0MjU2NDM0NTE3NDI0MzkwNjE=,22,j_604599,3,Terminated,276082,276121,39,100,0.39
task_LTg0MTUwNTA5Mjg4MDkwNjIzMA==,13,j_733273,10,Terminated,578498,578522,24,100,0.1
task_LTEwOTY0ODA4MjU3NTE0MjIwNTA=,45,j_496858,12,Terminated,621703,621731,28,100,0.96
task_LTcyMjgzNTU0Nzk1OTg3NTA5MzM=,45,j_496858,12,Terminated,621703,621739,36,100,1.34
task_LTEyMjkyMzM5NDA0NjY2NzEwMzY=,45,j_496858,12,Terminated,621703,621744,41,100,0.96
task_LTg0MTUwNTA5Mjg4MDkwNjIzMA==,10,j_128793,10,Terminated,578526,578547,21,100,0.1
task_NzQ3MjEzNzg0MzE5NDE5NzM1Mg==,13,j_9617,3,Terminated,470531,470577,46,100,1.53
task_LTEyMjkyMzM5NDA0NjY2NzEwMzY=,15,j_453050,12,Terminated,448948,448968,20,100,0.96
task_LTg0MTUwNTA5Mjg4MDkwNjIzMA==,49,j_696524,10,Terminated,492166,492186,20,100,0.1
task_LTEyMjkyMzM5NDA0NjY2NzEwMzY=,30,j_94654,12,Terminated,103373,103440,67,100,0.96
task_LTcyMjgzNTU0Nzk1OTg3NTA5MzM=,30,j_94654,12,Terminated,103373,103435,62,100,1.34
task_LTEwOTY0ODA4MjU3NTE0MjIwNTA=,30,j_94654,12,Terminated,103374,103425,51,100,0.96
task_LTEyMjkyMzM5NDA0NjY2NzEwMzY=,30,j_388380,12,Terminated,556989,557013,24,100,0.96
task_MzQwMDQzNjY0MzkwNzU2ODYyMg==,11,j_320284,3,Terminated,103389,103425,36,100,0.39
task_LTcyMjgzNTU0Nzk1OTg3NTA5MzM=,30,j_388380,12,Terminated,556989,557010,21,100,1.34
task_LTg0MTUwNTA5Mjg4MDkwNjIzMA==,21,j_358572,10,Terminated,319413,319434,21,100,0.1
task_LTg0MTUwNTA5Mjg4MDkwNjIzMA==,11,j_58811,10,Terminated,492223,492244,21,100,0.1
task_ODg3NTU4NTE3NDcxODA4NjA5Ng==,40,j_483299,3,Terminated,621834,621856,22,100,0.39
task_LTEyMjkyMzM5NDA0NjY2NzEwMzY=,10,j_271738,12,Terminated,362638,362678,40,100,0.96
task_LTEwOTY0ODA4MjU3NTE0MjIwNTA=,10,j_271738,12,Terminated,362638,362667,29,100,0.96
task_LTcyMjgzNTU0Nzk1OTg3NTA5MzM=,10,j_271738,12,Terminated,362639,362674,35,100,1.34
task_LTEyMjkyMzM5NDA0NjY2NzEwMzY=,35,j_371211,12,Terminated,449051,449077,26,100,0.96
task_LTcyMjgzNTU0Nzk1OTg3NTA5MzM=,35,j_371211,12,Terminated,449051,449073,22,100,1.34
task_LTg0MTUwNTA5Mjg4MDkwNjIzMA==,10,j_690680,10,Terminated,319466,319487,21,100,0.1
task_LTcyMjgzNTU0Nzk1OTg3NTA5MzM=,35,j_892556,12,Terminated,362678,362702,24,100,1.34
task_LTEyMjkyMzM5NDA0NjY2NzEwMzY=,35,j_892556,12,Terminated,362678,362706,28,100,0.96
task_LTEyMjkyMzM5NDA0NjY2NzEwMzY=,20,j_876373,12,Terminated,449173,449193,20,100,0.96
task_LTcyMjgzNTU0Nzk1OTg3NTA5MzM=,30,j_865392,12,Terminated,276443,276475,32,100,1.34
task_LTEwOTY0ODA4MjU3NTE0MjIwNTA=,30,j_865392,12,Terminated,276443,276467,24,100,0.96
task_LTEyMjkyMzM5NDA0NjY2NzEwMzY=,30,j_865392,12,Terminated,276443,276479,36,100,0.96
task_LTcyMjgzNTU0Nzk1OTg3NTA5MzM=,20,j_750221,12,Terminated,449262,449282,20,100,1.34
task_LTEyMjkyMzM5NDA0NjY2NzEwMzY=,20,j_750221,12,Terminated,449262,449286,24,100,0.96
task_LTEyMjkyMzM5NDA0NjY2NzEwMzY=,30,j_241557,12,Terminated,535689,535726,37,100,0.96
task_LTcyMjgzNTU0Nzk1OTg3NTA5MzM=,30,j_241557,12,Terminated,535689,535717,28,100,1.34
task_MTY3NzU4MzIxMzMzNDg4OTMzOQ==,17,j_226559,3,Terminated,233338,233392,54,100,0.39
task_Mjc5MzA3NTE4MTEyMDI2MTQ2OQ==,17,j_226559,3,Terminated,233338,233420,82,100,0.39
task_LTg0MTUwNTA5Mjg4MDkwNjIzMA==,32,j_555362,10,Terminated,319739,319764,25,100,0.1
task_LTE3Nzc5Mzc0NTEyODIyMTQwNTc=,17,j_226559,3,Terminated,233339,233374,35,100,0.39
task_LTcyMjgzNTU0Nzk1OTg3NTA5MzM=,65,j_756613,12,Terminated,362958,362985,27,100,1.34
task_LTEyMjkyMzM5NDA0NjY2NzEwMzY=,65,j_756613,12,Terminated,362958,362990,32,100,0.96
task_LTEyMjkyMzM5NDA0NjY2NzEwMzY=,45,j_803983,12,Terminated,449360,449383,23,100,0.96
task_LTEyMjkyMzM5NDA0NjY2NzEwMzY=,20,j_604323,12,Terminated,449373,449393,20,100,0.96
task_ODg3NTU4NTE3NDcxODA4NjA5Ng==,43,j_797490,3,Terminated,557457,557550,93,100,0.39
task_ODg3NTU4NTE3NDcxODA4NjA5Ng==,21,j_289441,3,Terminated,600673,600749,76,100,0.39
task_ODg3NTU4NTE3NDcxODA4NjA5Ng==,40,j_625698,3,Terminated,363080,363116,36,100,0.39
task_ODg3NTU4NTE3NDcxODA4NjA5Ng==,11,j_562029,3,Terminated,211894,211933,39,100,0.2
task_NzQ3MjEzNzg0MzE5NDE5NzM1Mg==,49,j_600672,3,Terminated,579109,579240,131,100,1.53
task_ODg3NTU4NTE3NDcxODA4NjA5Ng==,21,j_127701,3,Terminated,427914,427984,70,100,0.39
task_MzQwMDQzNjY0MzkwNzU2ODYyMg==,21,j_727211,12,Terminated,276733,276783,50,100,0.39
task_LTcyMjgzNTU0Nzk1OTg3NTA5MzM=,15,j_342616,12,Terminated,535944,535964,20,100,1.34
task_LTEyMjkyMzM5NDA0NjY2NzEwMzY=,15,j_342616,12,Terminated,535944,535967,23,100,0.96
task_LTI0MjU2NDM0NTE3NDI0MzkwNjE=,35,j_134691,3,Terminated,665547,665584,37,100,0.39
task_MzQwMDQzNjY0MzkwNzU2ODYyMg==,43,j_789360,3,Terminated,643963,643983,20,100,0.39
task_LTI0MjU2NDM0NTE3NDI0MzkwNjE=,43,j_789360,3,Terminated,643963,644009,46,100,0.39
task_LTI0MjU2NDM0NTE3NDI0MzkwNjE=,43,j_766910,3,Terminated,665592,665639,47,100,0.39
task_MzQwMDQzNjY0MzkwNzU2ODYyMg==,43,j_766910,3,Terminated,665592,665612,20,100,0.39
task_LTI0MjU2NDM0NTE3NDI0MzkwNjE=,40,j_291891,3,Terminated,665612,665650,38,100,0.39
task_LTg0MTUwNTA5Mjg4MDkwNjIzMA==,20,j_758646,10,Terminated,579275,579296,21,100,0.1
task_LTg0MTUwNTA5Mjg4MDkwNjIzMA==,14,j_32055,10,Terminated,492877,492902,25,100,0.1
task_LTg0MTUwNTA5Mjg4MDkwNjIzMA==,16,j_601871,10,Terminated,579289,579322,33,100,0.1
task_LTEyMjkyMzM5NDA0NjY2NzEwMzY=,65,j_54246,12,Terminated,190538,190571,33,100,0.96
task_LTEwOTY0ODA4MjU3NTE0MjIwNTA=,65,j_54246,12,Terminated,190538,190558,20,100,0.96
task_LTcyMjgzNTU0Nzk1OTg3NTA5MzM=,65,j_54246,12,Terminated,190538,190567,29,100,1.34
task_LTg0MTUwNTA5Mjg4MDkwNjIzMA==,18,j_744355,10,Terminated,492946,492968,22,100,0.1
task_LTg0MTUwNTA5Mjg4MDkwNjIzMA==,23,j_189687,10,Terminated,492985,493018,33,100,0.1
task_LTg0MTUwNTA5Mjg4MDkwNjIzMA==,11,j_116928,10,Terminated,320198,320227,29,100,0.1
task_LTg0MTUwNTA5Mjg4MDkwNjIzMA==,15,j_447371,10,Terminated,579400,579424,24,100,0.1
task_LTEyMjkyMzM5NDA0NjY2NzEwMzY=,10,j_512663,12,Terminated,277021,277047,26,100,0.96
task_LTcyMjgzNTU0Nzk1OTg3NTA5MzM=,10,j_512663,12,Terminated,277021,277043,22,100,1.34
task_LTEyMjkyMzM5NDA0NjY2NzEwMzY=,15,j_702356,12,Terminated,104366,104395,29,100,0.96
task_LTcyMjgzNTU0Nzk1OTg3NTA5MzM=,15,j_702356,12,Terminated,104366,104391,25,100,1.34
task_LTg0MTUwNTA5Mjg4MDkwNjIzMA==,15,j_826869,10,Terminated,579592,579625,33,100,0.1
task_ODYzMjgxNTM3NDQ2NzUwMjQxMg==,31,j_86624,8,Terminated,169218,169266,48,100,0.59
task_OTg1NjA1OTIxMzA4ODkxNg==,91,j_86624,8,Terminated,169218,169241,23,100,0.59
task_ODYzMjgxNTM3NDQ2NzUwMjQxMg==,23,j_384780,8,Terminated,493222,493283,61,100,0.59
task_OTg1NjA1OTIxMzA4ODkxNg==,67,j_384780,8,Terminated,493222,493251,29,100,0.59
task_OTg1NjA1OTIxMzA4ODkxNg==,67,j_66367,8,Terminated,406823,406851,28,100,0.59
task_ODYzMjgxNTM3NDQ2NzUwMjQxMg==,23,j_66367,8,Terminated,406823,406873,50,100,0.59
task_LTg0MTUwNTA5Mjg4MDkwNjIzMA==,16,j_424647,10,Terminated,320424,320452,28,100,0.1
task_OTg1NjA1OTIxMzA4ODkxNg==,19,j_589735,8,Terminated,622826,622861,35,100,0.59
task_OTg1NjA1OTIxMzA4ODkxNg==,91,j_204660,8,Terminated,687634,687657,23,100,0.59
task_ODYzMjgxNTM3NDQ2NzUwMjQxMg==,31,j_204660,8,Terminated,687634,687686,52,100,0.59
task_OTg1NjA1OTIxMzA4ODkxNg==,99,j_669102,8,Terminated,450048,450229,181,100,0.59
task_OTg1NjA1OTIxMzA4ODkxNg==,93,j_743231,8,Terminated,536463,536633,170,100,0.59
task_LTg0MTUwNTA5Mjg4MDkwNjIzMA==,38,j_870476,10,Terminated,493276,493296,20,100,0.1
task_LTEyMjkyMzM5NDA0NjY2NzEwMzY=,20,j_426329,12,Terminated,104496,104520,24,100,0.96
task_LTI0MjU2NDM0NTE3NDI0MzkwNjE=,20,j_604346,3,Terminated,363698,363735,37,100,0.39
task_OTg1NjA1OTIxMzA4ODkxNg==,19,j_693134,8,Terminated,277307,277336,29,100,0.59
task_MzQwMDQzNjY0MzkwNzU2ODYyMg==,13,j_180224,3,Terminated,558118,558156,38,100,0.33
task_MzQwMDQzNjY0MzkwNzU2ODYyMg==,85,j_105960,12,Terminated,342147,342210,63,100,0.39
task_LTcyMjgzNTU0Nzk1OTg3NTA5MzM=,25,j_720868,12,Terminated,104573,104596,23,100,1.34
task_LTEyMjkyMzM5NDA0NjY2NzEwMzY=,25,j_720868,12,Terminated,104573,104600,27,100,0.96
task_LTg0MTUwNTA5Mjg4MDkwNjIzMA==,12,j_721550,10,Terminated,320620,320653,33,100,0.1
task_LTEyMjkyMzM5NDA0NjY2NzEwMzY=,10,j_222948,12,Terminated,450238,450286,48,100,0.96
task_LTcyMjgzNTU0Nzk1OTg3NTA5MzM=,10,j_222948,12,Terminated,450238,450279,41,100,1.34
task_LTEwOTY0ODA4MjU3NTE0MjIwNTA=,10,j_222948,12,Terminated,450238,450260,22,100,0.96
task_LTg0MTUwNTA5Mjg4MDkwNjIzMA==,24,j_383352,10,Terminated,320703,320738,35,100,0.1
task_OTg1NjA1OTIxMzA4ODkxNg==,28,j_627217,8,Terminated,579917,580016,99,100,0.59
task_OTg1NjA1OTIxMzA4ODkxNg==,28,j_570965,8,Terminated,234321,234394,73,100,0.59
task_LTcyMjgzNTU0Nzk1OTg3NTA5MzM=,55,j_473060,12,Terminated,104736,104763,27,100,1.34
task_LTEyMjkyMzM5NDA0NjY2NzEwMzY=,55,j_473060,12,Terminated,104736,104768,32,100,0.96
task_LTg0MTUwNTA5Mjg4MDkwNjIzMA==,13,j_5624,10,Terminated,126368,126540,172,75,0.1
task_LTEyMjkyMzM5NDA0NjY2NzEwMzY=,30,j_699984,12,Terminated,191196,191272,76,100,0.96
task_LTEwOTY0ODA4MjU3NTE0MjIwNTA=,30,j_699984,12,Terminated,191196,191237,41,100,0.96
task_LTI0MjU2NDM0NTE3NDI0MzkwNjE=,27,j_457423,3,Terminated,644796,644832,36,100,0.39
task_LTcyMjgzNTU0Nzk1OTg3NTA5MzM=,30,j_699984,12,Terminated,191197,191255,58,100,1.34
task_LTI0MjU2NDM0NTE3NDI0MzkwNjE=,19,j_448053,3,Terminated,644801,644841,40,100,0.39
task_LTEyMjkyMzM5NDA0NjY2NzEwMzY=,10,j_437130,12,Terminated,191211,191250,39,100,0.96
task_LTcyMjgzNTU0Nzk1OTg3NTA5MzM=,10,j_437130,12,Terminated,191211,191237,26,100,1.34
task_MzQwMDQzNjY0MzkwNzU2ODYyMg==,25,j_585621,3,Terminated,148016,148073,57,100,0.39
task_LTg0MTUwNTA5Mjg4MDkwNjIzMA==,24,j_756803,10,Terminated,493616,493639,23,100,0.1
task_ODg3NTU4NTE3NDcxODA4NjA5Ng==,40,j_213887,3,Terminated,104819,104847,28,100,0.39
task_LTg0MTUwNTA5Mjg4MDkwNjIzMA==,10,j_420340,8,Terminated,256093,256126,33,100,0.1
task_LTcyMjgzNTU0Nzk1OTg3NTA5MzM=,30,j_889039,12,Terminated,277770,277790,20,100,1.34
task_LTEyMjkyMzM5NDA0NjY2NzEwMzY=,30,j_889039,12,Terminated,277770,277796,26,100,0.96
task_LTg0MTUwNTA5Mjg4MDkwNjIzMA==,13,j_112239,10,Terminated,320982,321015,33,100,0.1
task_LTg0MTUwNTA5Mjg4MDkwNjIzMA==,15,j_281160,10,Terminated,126691,126817,126,100,0.1
task_LTg0MTUwNTA5Mjg4MDkwNjIzMA==,33,j_219750,10,Terminated,299502,299559,57,100,0.1
task_LTg0MTUwNTA5Mjg4MDkwNjIzMA==,27,j_299255,10,Terminated,126704,126819,115,100,0.1
task_LTg0MTUwNTA5Mjg4MDkwNjIzMA==,85,j_826660,10,Terminated,472314,472378,64,100,0.1
task_LTg0MTUwNTA5Mjg4MDkwNjIzMA==,14,j_747291,10,Terminated,472318,472398,80,100,0.1
task_LTg0MTUwNTA5Mjg4MDkwNjIzMA==,28,j_581576,10,Terminated,558719,558780,61,100,0.1
task_LTg0MTUwNTA5Mjg4MDkwNjIzMA==,64,j_500917,10,Terminated,558722,558777,55,100,0.1
task_MzQwMDQzNjY0MzkwNzU2ODYyMg==,21,j_60212,12,Terminated,364323,364352,29,100,0.39
task_LTg0MTUwNTA5Mjg4MDkwNjIzMA==,75,j_730900,10,Terminated,472324,472382,58,100,0.1
task_LTg0MTUwNTA5Mjg4MDkwNjIzMA==,14,j_792863,10,Terminated,126724,126924,200,75,0.1
task_LTI0MjU2NDM0NTE3NDI0MzkwNjE=,24,j_719231,3,Terminated,537126,537161,35,100,0.39
task_LTg0MTUwNTA5Mjg4MDkwNjIzMA==,27,j_274372,10,Terminated,472327,472390,63,100,0.1
task_LTg0MTUwNTA5Mjg4MDkwNjIzMA==,26,j_507750,10,Terminated,472329,472392,63,100,0.1
task_ODg3NTU4NTE3NDcxODA4NjA5Ng==,40,j_823507,3,Terminated,450743,450772,29,100,0.39
task_LTEyMjkyMzM5NDA0NjY2NzEwMzY=,25,j_5809,12,Terminated,277944,277971,27,100,0.96
task_LTcyMjgzNTU0Nzk1OTg3NTA5MzM=,25,j_5809,12,Terminated,277944,277967,23,100,1.34
task_LTg0MTUwNTA5Mjg4MDkwNjIzMA==,43,j_217827,10,Terminated,126746,126814,68,100,0.1
task_LTI0MjU2NDM0NTE3NDI0MzkwNjE=,23,j_849850,3,Terminated,580372,580415,43,100,0.39
task_LTg0MTUwNTA5Mjg4MDkwNjIzMA==,83,j_674336,10,Terminated,299577,299613,36,100,0.1
task_LTg0MTUwNTA5Mjg4MDkwNjIzMA==,45,j_642950,10,Terminated,213182,213222,40,100,0.1
task_LTg0MTUwNTA5Mjg4MDkwNjIzMA==,27,j_606821,10,Terminated,299586,299636,50,100,0.1
task_LTg0MTUwNTA5Mjg4MDkwNjIzMA==,31,j_324958,10,Terminated,126801,126997,196,75,0.1
task_LTg0MTUwNTA5Mjg4MDkwNjIzMA==,10,j_148636,8,Terminated,213205,213230,25,100,0.1
task_LTg0MTUwNTA5Mjg4MDkwNjIzMA==,92,j_288597,10,Terminated,558806,558854,48,100,0.1
task_LTg0MTUwNTA5Mjg4MDkwNjIzMA==,89,j_347589,10,Terminated,472411,472460,49,100,0.1
task_LTg0MTUwNTA5Mjg4MDkwNjIzMA==,90,j_122398,10,Terminated,126813,126898,85,100,0.1
task_LTg0MTUwNTA5Mjg4MDkwNjIzMA==,45,j_198841,10,Terminated,299648,299691,43,100,0.1
task_LTg0MTUwNTA5Mjg4MDkwNjIzMA==,19,j_942,10,Terminated,321252,321275,23,100,0.1
task_LTg0MTUwNTA5Mjg4MDkwNjIzMA==,17,j_752742,10,Terminated,213252,213296,44,100,0.1
task_LTg5MTI5MTc1ODQzMjE2MTczMTk=,43,j_195554,3,Terminated,148453,148548,95,100,0.79
task_LTg0MTUwNTA5Mjg4MDkwNjIzMA==,50,j_122998,10,Terminated,299653,299714,61,100,0.1
task_LTg5MTI5MTc1ODQzMjE2MTczMTk=,40,j_912614,3,Terminated,602065,602177,112,100,0.79
task_LTg0MTUwNTA5Mjg4MDkwNjIzMA==,11,j_494937,10,Terminated,234888,234916,28,100,0.1
task_LTg0MTUwNTA5Mjg4MDkwNjIzMA==,61,j_223164,10,Terminated,558888,558948,60,100,0.1
task_LTg0MTUwNTA5Mjg4MDkwNjIzMA==,61,j_256279,10,Terminated,558906,558994,88,100,0.1
task_LTg0MTUwNTA5Mjg4MDkwNjIzMA==,14,j_334630,10,Terminated,213311,213382,71,100,0.1
task_LTg0MTUwNTA5Mjg4MDkwNjIzMA==,27,j_11494,10,Terminated,472518,472569,51,100,0.1
task_LTg0MTUwNTA5Mjg4MDkwNjIzMA==,28,j_693953,10,Terminated,126927,126992,65,100,0.1
task_LTg0MTUwNTA5Mjg4MDkwNjIzMA==,17,j_369794,10,Terminated,126931,126997,66,100,0.1
task_LTg0MTUwNTA5Mjg4MDkwNjIzMA==,28,j_141135,10,Terminated,645336,645403,67,100,0.1
task_LTg0MTUwNTA5Mjg4MDkwNjIzMA==,76,j_844092,10,Terminated,299753,299822,69,100,0.1
task_LTg0MTUwNTA5Mjg4MDkwNjIzMA==,33,j_856898,10,Terminated,472560,472601,41,100,0.1
task_ODg3NTU4NTE3NDcxODA4NjA5Ng==,24,j_511263,3,Terminated,386171,386239,68,100,0.39
task_LTg0MTUwNTA5Mjg4MDkwNjIzMA==,97,j_691555,10,Terminated,558981,559074,93,100,0.1
task_LTg0MTUwNTA5Mjg4MDkwNjIzMA==,10,j_312412,10,Terminated,472584,472679,95,100,0.1
task_LTg0MTUwNTA5Mjg4MDkwNjIzMA==,92,j_94425,10,Terminated,472598,472635,37,100,0.1
task_LTg0MTUwNTA5Mjg4MDkwNjIzMA==,88,j_134578,10,Terminated,645399,645436,37,100,0.1
task_MzQwMDQzNjY0MzkwNzU2ODYyMg==,74,j_675126,12,Terminated,537400,537460,60,100,0.39
task_NzQ3MjEzNzg0MzE5NDE5NzM1Mg==,18,j_57138,3,Terminated,256619,256654,35,100,1.53
task_LTg0MTUwNTA5Mjg4MDkwNjIzMA==,55,j_335434,10,Terminated,559046,559080,34,100,0.1
task_LTg0MTUwNTA5Mjg4MDkwNjIzMA==,96,j_784275,10,Terminated,645450,645476,26,100,0.1
task_LTg0MTUwNTA5Mjg4MDkwNjIzMA==,43,j_829178,10,Terminated,213458,213564,106,100,0.1
task_LTg5MTI5MTc1ODQzMjE2MTczMTk=,40,j_269028,3,Terminated,343064,343155,91,100,0.79
task_LTg0MTUwNTA5Mjg4MDkwNjIzMA==,92,j_668037,10,Terminated,472669,472705,36,100,0.1
task_LTg0MTUwNTA5Mjg4MDkwNjIzMA==,18,j_238369,10,Terminated,559082,559147,65,100,0.1
task_LTg0MTUwNTA5Mjg4MDkwNjIzMA==,89,j_320698,10,Terminated,645494,645527,33,100,0.1
task_ODg3NTU4NTE3NDcxODA4NjA5Ng==,60,j_815389,3,Terminated,645511,645550,39,100,0.39
task_MzQwMDQzNjY0MzkwNzU2ODYyMg==,24,j_645027,3,Terminated,256724,256746,22,100,0.77
task_LTg0MTUwNTA5Mjg4MDkwNjIzMA==,79,j_828519,10,Terminated,127124,127225,101,100,0.1
task_LTI0MjU2NDM0NTE3NDI0MzkwNjE=,100,j_645027,3,Terminated,256724,256760,36,100,0.77
task_LTg0MTUwNTA5Mjg4MDkwNjIzMA==,20,j_381628,10,Terminated,321539,321559,20,100,0.1
task_LTg0MTUwNTA5Mjg4MDkwNjIzMA==,14,j_344019,10,Terminated,299946,300058,112,100,0.1
task_LTg0MTUwNTA5Mjg4MDkwNjIzMA==,15,j_656703,10,Terminated,299962,300093,131,100,0.1
task_LTg0MTUwNTA5Mjg4MDkwNjIzMA==,27,j_885059,10,Terminated,472765,472821,56,100,0.1
task_LTg5MTI5MTc1ODQzMjE2MTczMTk=,42,j_503714,3,Terminated,299990,300136,146,100,0.79
task_LTg0MTUwNTA5Mjg4MDkwNjIzMA==,27,j_411533,10,Terminated,559191,559301,110,100,0.1
task_LTg0MTUwNTA5Mjg4MDkwNjIzMA==,92,j_242217,10,Terminated,559198,559300,102,100,0.1
task_LTg0MTUwNTA5Mjg4MDkwNjIzMA==,94,j_415663,10,Terminated,127203,127252,49,100,0.1
task_LTI0MjU2NDM0NTE3NDI0MzkwNjE=,41,j_167205,3,Terminated,667205,667280,75,100,0.39
task_LTg0MTUwNTA5Mjg4MDkwNjIzMA==,12,j_7750,10,Terminated,127206,127268,62,100,0.1
task_LTEyMjkyMzM5NDA0NjY2NzEwMzY=,80,j_607719,12,Terminated,105608,105681,73,100,0.96
task_LTcyMjgzNTU0Nzk1OTg3NTA5MzM=,80,j_607719,12,Terminated,105608,105635,27,100,1.34
task_LTI0MjU2NDM0NTE3NDI0MzkwNjE=,38,j_820508,3,Terminated,667211,667249,38,100,0.39
task_LTg0MTUwNTA5Mjg4MDkwNjIzMA==,11,j_286980,10,Terminated,667215,667273,58,100,0.1
task_LTg0MTUwNTA5Mjg4MDkwNjIzMA==,89,j_339907,10,Terminated,645619,645659,40,100,0.1
task_LTg0MTUwNTA5Mjg4MDkwNjIzMA==,13,j_448420,10,Terminated,645637,645753,116,100,0.1
task_LTg0MTUwNTA5Mjg4MDkwNjIzMA==,27,j_815447,10,Terminated,472846,472907,61,100,0.1
task_LTg0MTUwNTA5Mjg4MDkwNjIzMA==,100,j_743362,10,Terminated,645657,645704,47,100,0.1
task_LTI0MjU2NDM0NTE3NDI0MzkwNjE=,72,j_428019,3,Terminated,624074,624148,74,100,0.39
task_MzQwMDQzNjY0MzkwNzU2ODYyMg==,72,j_428019,3,Terminated,624074,624096,22,100,0.39
task_LTg0MTUwNTA5Mjg4MDkwNjIzMA==,51,j_534107,10,Terminated,472894,472950,56,100,0.1
task_LTI0MjU2NDM0NTE3NDI0MzkwNjE=,100,j_52947,3,Terminated,170502,170537,35,100,0.77
task_MzQwMDQzNjY0MzkwNzU2ODYyMg==,24,j_52947,3,Terminated,170502,170522,20,100,0.77
task_LTg0MTUwNTA5Mjg4MDkwNjIzMA==,28,j_715266,10,Terminated,559304,559379,75,100,0.1
task_LTg0MTUwNTA5Mjg4MDkwNjIzMA==,11,j_127406,10,Terminated,580911,580968,57,100,0.1
task_LTg0MTUwNTA5Mjg4MDkwNjIzMA==,95,j_749759,10,Terminated,645717,645764,47,100,0.1
task_LTg0MTUwNTA5Mjg4MDkwNjIzMA==,14,j_546297,10,Terminated,127324,127509,185,75,0.1
task_LTg0MTUwNTA5Mjg4MDkwNjIzMA==,14,j_665238,10,Terminated,580930,580958,28,100,0.1
task_LTg0MTUwNTA5Mjg4MDkwNjIzMA==,12,j_676008,10,Terminated,667359,667383,24,100,0.1
task_LTg0MTUwNTA5Mjg4MDkwNjIzMA==,89,j_189906,10,Terminated,127369,127403,34,100,0.1
task_LTg0MTUwNTA5Mjg4MDkwNjIzMA==,26,j_771400,10,Terminated,127377,127461,84,100,0.1
task_LTg0MTUwNTA5Mjg4MDkwNjIzMA==,27,j_56089,10,Terminated,127379,127423,44,100,0.1
task_LTg0MTUwNTA5Mjg4MDkwNjIzMA==,49,j_630610,10,Terminated,559399,559434,35,100,0.1
task_MzQwMDQzNjY0MzkwNzU2ODYyMg==,54,j_6888,12,Terminated,451408,451587,179,100,0.39
task_LTI0MjU2NDM0NTE3NDI0MzkwNjE=,17,j_159610,3,Terminated,365023,365079,56,100,0.39
task_LTg0MTUwNTA5Mjg4MDkwNjIzMA==,27,j_473534,10,Terminated,473023,473070,47,100,0.1
task_LTg0MTUwNTA5Mjg4MDkwNjIzMA==,73,j_766810,10,Terminated,473027,473063,36,100,0.1
task_LTg0MTUwNTA5Mjg4MDkwNjIzMA==,89,j_716477,10,Terminated,127432,127469,37,100,0.1
task_LTg0MTUwNTA5Mjg4MDkwNjIzMA==,98,j_624000,10,Terminated,127457,127489,32,100,0.1
task_LTg0MTUwNTA5Mjg4MDkwNjIzMA==,63,j_37299,10,Terminated,645866,645909,43,100,0.1
task_LTg0MTUwNTA5Mjg4MDkwNjIzMA==,54,j_284920,10,Terminated,473066,473100,34,100,0.1
task_LTg0MTUwNTA5Mjg4MDkwNjIzMA==,40,j_684673,10,Terminated,213868,213932,64,100,0.1
task_LTg0MTUwNTA5Mjg4MDkwNjIzMA==,47,j_797571,10,Terminated,473072,473144,72,100,0.1
task_LTg0MTUwNTA5Mjg4MDkwNjIzMA==,16,j_68221,10,Terminated,213875,213914,39,100,0.1
task_LTg0MTUwNTA5Mjg4MDkwNjIzMA==,56,j_412964,10,Terminated,473079,473116,37,100,0.1
task_LTg0MTUwNTA5Mjg4MDkwNjIzMA==,27,j_667081,10,Terminated,645881,645938,57,100,0.1
task_LTg0MTUwNTA5Mjg4MDkwNjIzMA==,11,j_802077,10,Terminated,581082,581121,39,100,0.1
task_LTg0MTUwNTA5Mjg4MDkwNjIzMA==,14,j_150937,10,Terminated,581086,581132,46,100,0.1
task_LTg0MTUwNTA5Mjg4MDkwNjIzMA==,27,j_846640,10,Terminated,213889,213931,42,100,0.1
task_LTg0MTUwNTA5Mjg4MDkwNjIzMA==,15,j_62622,10,Terminated,213889,213923,34,100,0.1
task_LTg0MTUwNTA5Mjg4MDkwNjIzMA==,80,j_651314,10,Terminated,559494,559522,28,100,0.1
task_LTg0MTUwNTA5Mjg4MDkwNjIzMA==,11,j_346368,10,Terminated,581103,581160,57,100,0.1
task_LTg0MTUwNTA5Mjg4MDkwNjIzMA==,78,j_729563,10,Terminated,300312,300379,67,100,0.1
task_LTg0MTUwNTA5Mjg4MDkwNjIzMA==,14,j_298162,10,Terminated,213918,213954,36,100,0.1
task_LTg0MTUwNTA5Mjg4MDkwNjIzMA==,17,j_687057,10,Terminated,473121,473179,58,100,0.1
task_LTg0MTUwNTA5Mjg4MDkwNjIzMA==,44,j_842614,10,Terminated,473156,473196,40,100,0.1
task_LTg0MTUwNTA5Mjg4MDkwNjIzMA==,79,j_757036,10,Terminated,473157,473214,57,100,0.1
task_LTg0MTUwNTA5Mjg4MDkwNjIzMA==,16,j_9230,10,Terminated,127566,127603,37,100,0.1
task_MzQwMDQzNjY0MzkwNzU2ODYyMg==,50,j_888426,3,Terminated,127576,127604,28,100,0.77
task_LTI0MjU2NDM0NTE3NDI0MzkwNjE=,100,j_888426,3,Terminated,127576,127641,65,100,0.77
task_LTg0MTUwNTA5Mjg4MDkwNjIzMA==,13,j_226510,10,Terminated,213994,214037,43,100,0.1
task_LTg0MTUwNTA5Mjg4MDkwNjIzMA==,21,j_767503,10,Terminated,127608,127728,120,75,0.1
task_LTg0MTUwNTA5Mjg4MDkwNjIzMA==,23,j_244258,10,Terminated,559616,559646,30,100,0.1
task_LTg0MTUwNTA5Mjg4MDkwNjIzMA==,13,j_422382,10,Terminated,473217,473256,39,100,0.1
task_LTI0MjU2NDM0NTE3NDI0MzkwNjE=,20,j_297662,3,Terminated,214041,214095,54,100,0.39
task_MzQwMDQzNjY0MzkwNzU2ODYyMg==,20,j_297662,3,Terminated,214041,214066,25,100,0.39
task_LTg0MTUwNTA5Mjg4MDkwNjIzMA==,11,j_554893,10,Terminated,581248,581275,27,100,0.1
task_LTcyMjgzNTU0Nzk1OTg3NTA5MzM=,30,j_809511,12,Terminated,192449,192469,20,100,1.34
task_LTEyMjkyMzM5NDA0NjY2NzEwMzY=,30,j_809511,12,Terminated,192449,192473,24,100,0.96
task_LTg0MTUwNTA5Mjg4MDkwNjIzMA==,13,j_428060,10,Terminated,300459,300529,70,100,0.1
task_LTg0MTUwNTA5Mjg4MDkwNjIzMA==,12,j_70822,10,Terminated,127660,127693,33,100,0.1
task_LTg0MTUwNTA5Mjg4MDkwNjIzMA==,12,j_567910,10,Terminated,127678,127723,45,100,0.1
task_LTg0MTUwNTA5Mjg4MDkwNjIzMA==,90,j_909377,10,Terminated,214083,214114,31,100,0.1
task_LTg0MTUwNTA5Mjg4MDkwNjIzMA==,46,j_481215,10,Terminated,494889,494912,23,100,0.1
task_LTg0MTUwNTA5Mjg4MDkwNjIzMA==,46,j_216991,10,Terminated,127693,127893,200,75,0.1
task_LTg0MTUwNTA5Mjg4MDkwNjIzMA==,84,j_225217,10,Terminated,559702,559738,36,100,0.1
task_LTg0MTUwNTA5Mjg4MDkwNjIzMA==,10,j_254024,10,Terminated,559716,559759,43,100,0.1
task_LTg0MTUwNTA5Mjg4MDkwNjIzMA==,84,j_540842,10,Terminated,646123,646176,53,100,0.1
task_LTg0MTUwNTA5Mjg4MDkwNjIzMA==,26,j_780769,10,Terminated,214124,214175,51,100,0.1
task_LTEyMjkyMzM5NDA0NjY2NzEwMzY=,30,j_823186,12,Terminated,192535,192565,30,100,0.96
task_LTcyMjgzNTU0Nzk1OTg3NTA5MzM=,30,j_823186,12,Terminated,192535,192561,26,100,1.34
task_LTI0MjU2NDM0NTE3NDI0MzkwNjE=,19,j_528474,3,Terminated,127752,127796,44,100,0.39
task_LTg0MTUwNTA5Mjg4MDkwNjIzMA==,32,j_192543,10,Terminated,300556,300616,60,100,0.1
task_LTg0MTUwNTA5Mjg4MDkwNjIzMA==,40,j_142751,10,Terminated,559772,559805,33,100,0.1
task_LTg0MTUwNTA5Mjg4MDkwNjIzMA==,27,j_64921,10,Terminated,559789,559847,58,100,0.1
task_LTg0MTUwNTA5Mjg4MDkwNjIzMA==,36,j_380476,10,Terminated,473393,473443,50,100,0.1
task_LTg0MTUwNTA5Mjg4MDkwNjIzMA==,43,j_189006,10,Terminated,494994,495016,22,100,0.1
task_LTg0MTUwNTA5Mjg4MDkwNjIzMA==,18,j_101537,10,Terminated,646195,646247,52,100,0.1
task_LTg0MTUwNTA5Mjg4MDkwNjIzMA==,93,j_63344,10,Terminated,473402,473457,55,100,0.1
task_ODYzMjgxNTM3NDQ2NzUwMjQxMg==,17,j_288473,8,Terminated,300617,300662,45,100,0.59
task_ODYzMjgxNTM3NDQ2NzUwMjQxMg==,17,j_651931,8,Terminated,559818,559886,68,100,0.59
task_OTg1NjA1OTIxMzA4ODkxNg==,45,j_651931,8,Terminated,559818,559853,35,100,0.59
task_ODYzMjgxNTM3NDQ2NzUwMjQxMg==,33,j_322945,8,Terminated,603019,603082,63,100,0.59
task_OTg1NjA1OTIxMzA4ODkxNg==,93,j_322945,8,Terminated,603019,603051,32,100,0.59
task_ODYzMjgxNTM3NDQ2NzUwMjQxMg==,33,j_53668,8,Terminated,689420,689447,27,100,0.59
task_ODYzMjgxNTM3NDQ2NzUwMjQxMg==,25,j_198726,8,Terminated,495021,495062,41,100,0.59
task_ODYzMjgxNTM3NDQ2NzUwMjQxMg==,33,j_641310,8,Terminated,516622,516671,49,100,0.59
task_OTg1NjA1OTIxMzA4ODkxNg==,93,j_641310,8,Terminated,516622,516645,23,100,0.59
task_LTg0MTUwNTA5Mjg4MDkwNjIzMA==,38,j_642466,10,Terminated,495024,495049,25,100,0.1
task_LTg0MTUwNTA5Mjg4MDkwNjIzMA==,99,j_889688,10,Terminated,300629,300699,70,100,0.1
task_LTg0MTUwNTA5Mjg4MDkwNjIzMA==,81,j_526009,10,Terminated,127837,127871,34,100,0.1
task_LTg0MTUwNTA5Mjg4MDkwNjIzMA==,13,j_774588,10,Terminated,214241,214276,35,100,0.1
task_OTg1NjA1OTIxMzA4ODkxNg==,21,j_302641,8,Terminated,624647,624786,139,100,0.59
task_LTg0MTUwNTA5Mjg4MDkwNjIzMA==,12,j_898715,10,Terminated,559852,559902,50,100,0.1
task_LTg0MTUwNTA5Mjg4MDkwNjIzMA==,55,j_238903,10,Terminated,559873,559932,59,100,0.1
task_LTg0MTUwNTA5Mjg4MDkwNjIzMA==,96,j_525965,10,Terminated,300695,300772,77,100,0.1
task_LTg0MTUwNTA5Mjg4MDkwNjIzMA==,14,j_844054,10,Terminated,473501,473557,56,100,0.1
task_LTg0MTUwNTA5Mjg4MDkwNjIzMA==,16,j_70503,10,Terminated,473503,473566,63,100,0.1
task_LTg0MTUwNTA5Mjg4MDkwNjIzMA==,82,j_574646,10,Terminated,646307,646350,43,100,0.1
task_LTg0MTUwNTA5Mjg4MDkwNjIzMA==,14,j_71535,10,Terminated,473516,473567,51,100,0.1
task_LTg0MTUwNTA5Mjg4MDkwNjIzMA==,14,j_191757,10,Terminated,127925,127970,45,100,0.1
task_LTg0MTUwNTA5Mjg4MDkwNjIzMA==,12,j_405752,10,Terminated,127926,127964,38,100,0.1
task_LTg0MTUwNTA5Mjg4MDkwNjIzMA==,11,j_6510,10,Terminated,581537,581582,45,100,0.1
task_LTg0MTUwNTA5Mjg4MDkwNjIzMA==,73,j_482760,10,Terminated,127940,127974,34,100,0.1
task_LTg0MTUwNTA5Mjg4MDkwNjIzMA==,10,j_818717,10,Terminated,559955,560002,47,100,0.1
task_LTg0MTUwNTA5Mjg4MDkwNjIzMA==,56,j_176172,10,Terminated,559966,560012,46,100,0.1
task_LTg0MTUwNTA5Mjg4MDkwNjIzMA==,20,j_721647,10,Terminated,667972,667998,26,100,0.1
task_LTg0MTUwNTA5Mjg4MDkwNjIzMA==,27,j_291534,10,Terminated,127974,128004,30,100,0.1
task_LTg0MTUwNTA5Mjg4MDkwNjIzMA==,10,j_885562,10,Terminated,559975,560035,60,100,0.1
task_LTg0MTUwNTA5Mjg4MDkwNjIzMA==,14,j_73323,10,Terminated,473583,473620,37,100,0.1
task_LTg0MTUwNTA5Mjg4MDkwNjIzMA==,93,j_913085,10,Terminated,473588,473624,36,100,0.1
task_LTg0MTUwNTA5Mjg4MDkwNjIzMA==,96,j_227018,10,Terminated,300798,300865,67,100,0.1
task_LTI0MjU2NDM0NTE3NDI0MzkwNjE=,35,j_49856,3,Terminated,668015,668058,43,100,0.39
task_LTg0MTUwNTA5Mjg4MDkwNjIzMA==,16,j_296918,10,Terminated,128018,128049,31,100,0.1
task_LTg0MTUwNTA5Mjg4MDkwNjIzMA==,10,j_500456,10,Terminated,560028,560101,73,100,0.1
task_LTg0MTUwNTA5Mjg4MDkwNjIzMA==,28,j_525111,10,Terminated,128031,128058,27,100,0.1
task_LTg0MTUwNTA5Mjg4MDkwNjIzMA==,12,j_309663,10,Terminated,560032,560094,62,100,0.1
task_LTg0MTUwNTA5Mjg4MDkwNjIzMA==,13,j_307100,10,Terminated,581642,581682,40,100,0.1
task_LTg0MTUwNTA5Mjg4MDkwNjIzMA==,51,j_806884,10,Terminated,128045,128068,23,100,0.1
task_LTg0MTUwNTA5Mjg4MDkwNjIzMA==,32,j_583998,10,Terminated,473660,473712,52,100,0.1
task_LTg0MTUwNTA5Mjg4MDkwNjIzMA==,73,j_678833,10,Terminated,128074,128104,30,100,0.1
task_LTg0MTUwNTA5Mjg4MDkwNjIzMA==,10,j_57104,10,Terminated,646503,646555,52,100,0.1
task_LTg0MTUwNTA5Mjg4MDkwNjIzMA==,90,j_465608,10,Terminated,560124,560168,44,100,0.1
task_LTg0MTUwNTA5Mjg4MDkwNjIzMA==,73,j_46593,10,Terminated,128137,128170,33,100,0.1
task_LTg0MTUwNTA5Mjg4MDkwNjIzMA==,12,j_701376,10,Terminated,473742,473791,49,100,0.1
task_LTg0MTUwNTA5Mjg4MDkwNjIzMA==,36,j_376307,10,Terminated,128157,128186,29,100,0.1
task_LTg0MTUwNTA5Mjg4MDkwNjIzMA==,49,j_257161,10,Terminated,495366,495386,20,100,0.1
task_LTg0MTUwNTA5Mjg4MDkwNjIzMA==,11,j_145187,10,Terminated,301013,301048,35,100,0.1
task_LTg0MTUwNTA5Mjg4MDkwNjIzMA==,13,j_69415,10,Terminated,581819,581841,22,100,0.1
task_LTg0MTUwNTA5Mjg4MDkwNjIzMA==,87,j_120079,10,Terminated,128231,128270,39,100,0.1
task_LTg0MTUwNTA5Mjg4MDkwNjIzMA==,43,j_830247,10,Terminated,646632,646658,26,100,0.1
task_Mjc5MzA3NTE4MTEyMDI2MTQ2OQ==,32,j_345927,3,Terminated,581842,581936,94,100,0.39
task_LTE3Nzc5Mzc0NTEyODIyMTQwNTc=,32,j_345927,3,Terminated,581842,581905,63,100,0.39
task_MTY3NzU4MzIxMzMzNDg4OTMzOQ==,32,j_345927,3,Terminated,581842,581919,77,100,0.39
task_LTg0MTUwNTA5Mjg4MDkwNjIzMA==,16,j_525923,10,Terminated,128251,128440,189,75,0.1
task_LTg0MTUwNTA5Mjg4MDkwNjIzMA==,28,j_733211,10,Terminated,560265,560310,45,100,0.1
task_LTg0MTUwNTA5Mjg4MDkwNjIzMA==,40,j_333167,10,Terminated,128269,128294,25,100,0.1
task_LTg0MTUwNTA5Mjg4MDkwNjIzMA==,73,j_699090,10,Terminated,128269,128297,28,100,0.1
task_LTg0MTUwNTA5Mjg4MDkwNjIzMA==,84,j_445342,10,Terminated,473882,473908,26,100,0.1
task_LTg0MTUwNTA5Mjg4MDkwNjIzMA==,13,j_378552,10,Terminated,128297,128333,36,100,0.1
task_LTg0MTUwNTA5Mjg4MDkwNjIzMA==,98,j_488863,10,Terminated,473900,473928,28,100,0.1
task_LTg0MTUwNTA5Mjg4MDkwNjIzMA==,19,j_419023,10,Terminated,128335,128520,185,75,0.1
task_LTg0MTUwNTA5Mjg4MDkwNjIzMA==,26,j_886533,10,Terminated,301145,301168,23,100,0.1
task_LTg0MTUwNTA5Mjg4MDkwNjIzMA==,12,j_2239,10,Terminated,646760,646796,36,100,0.1
task_LTg0MTUwNTA5Mjg4MDkwNjIzMA==,16,j_513494,10,Terminated,322762,322782,20,100,0.1
task_LTg0MTUwNTA5Mjg4MDkwNjIzMA==,22,j_515568,10,Terminated,128390,128419,29,100,0.1
task_LTg0MTUwNTA5Mjg4MDkwNjIzMA==,38,j_288174,10,Terminated,214795,214837,42,100,0.1
task_LTg0MTUwNTA5Mjg4MDkwNjIzMA==,26,j_525368,10,Terminated,214808,214869,61,100,0.1
task_LTg0MTUwNTA5Mjg4MDkwNjIzMA==,12,j_227323,10,Terminated,474012,474050,38,100,0.1
task_LTg0MTUwNTA5Mjg4MDkwNjIzMA==,21,j_341388,10,Terminated,560417,560471,54,100,0.1
task_LTg0MTUwNTA5Mjg4MDkwNjIzMA==,13,j_200272,10,Terminated,474020,474057,37,100,0.1
task_LTg0MTUwNTA5Mjg4MDkwNjIzMA==,25,j_278660,10,Terminated,560438,560491,53,100,0.1
task_LTg0MTUwNTA5Mjg4MDkwNjIzMA==,10,j_30554,10,Terminated,646841,646878,37,100,0.1
task_LTg0MTUwNTA5Mjg4MDkwNjIzMA==,15,j_470552,10,Terminated,236441,236465,24,100,0.1
task_LTg0MTUwNTA5Mjg4MDkwNjIzMA==,55,j_539595,10,Terminated,214842,214894,52,100,0.1
task_LTg0MTUwNTA5Mjg4MDkwNjIzMA==,21,j_624047,10,Terminated,646869,646891,22,100,0.1
task_LTg0MTUwNTA5Mjg4MDkwNjIzMA==,11,j_7036,10,Terminated,301316,301348,32,100,0.1
task_LTg0MTUwNTA5Mjg4MDkwNjIzMA==,17,j_688863,10,Terminated,322924,322952,28,100,0.1
task_LTg0MTUwNTA5Mjg4MDkwNjIzMA==,34,j_258352,10,Terminated,560530,560558,28,100,0.1
task_LTg0MTUwNTA5Mjg4MDkwNjIzMA==,17,j_234909,10,Terminated,495739,495768,29,100,0.1
task_LTg0MTUwNTA5Mjg4MDkwNjIzMA==,15,j_333945,10,Terminated,474143,474173,30,100,0.1
task_LTg0MTUwNTA5Mjg4MDkwNjIzMA==,12,j_265453,10,Terminated,582144,582191,47,100,0.1
task_LTg0MTUwNTA5Mjg4MDkwNjIzMA==,10,j_342695,10,Terminated,474148,474180,32,100,0.1
task_LTg0MTUwNTA5Mjg4MDkwNjIzMA==,12,j_879910,10,Terminated,495750,495774,24,100,0.1
task_LTI0MjU2NDM0NTE3NDI0MzkwNjE=,53,j_672098,3,Terminated,150153,150208,55,100,0.39
task_MzQwMDQzNjY0MzkwNzU2ODYyMg==,53,j_672098,3,Terminated,150153,150176,23,100,0.39
task_LTg0MTUwNTA5Mjg4MDkwNjIzMA==,49,j_114663,10,Terminated,128565,128590,25,100,0.1
task_LTg0MTUwNTA5Mjg4MDkwNjIzMA==,12,j_615716,10,Terminated,301378,301462,84,100,0.1
task_LTI0MjU2NDM0NTE3NDI0MzkwNjE=,22,j_400619,3,Terminated,495785,495826,41,100,0.39
task_LTg0MTUwNTA5Mjg4MDkwNjIzMA==,14,j_531239,10,Terminated,128592,128635,43,100,0.1
task_LTg0MTUwNTA5Mjg4MDkwNjIzMA==,41,j_135951,10,Terminated,495793,495817,24,100,0.1
task_LTI0MjU2NDM0NTE3NDI0MzkwNjE=,35,j_752818,3,Terminated,106998,107055,57,100,0.39
task_LTg0MTUwNTA5Mjg4MDkwNjIzMA==,12,j_149147,10,Terminated,495802,495826,24,100,0.1
task_LTg0MTUwNTA5Mjg4MDkwNjIzMA==,23,j_213399,10,Terminated,647021,647046,25,100,0.1
task_LTg0MTUwNTA5Mjg4MDkwNjIzMA==,16,j_884854,10,Terminated,323029,323059,30,100,0.1
task_LTg0MTUwNTA5Mjg4MDkwNjIzMA==,48,j_696450,10,Terminated,301448,301482,34,100,0.1
task_MzQwMDQzNjY0MzkwNzU2ODYyMg==,61,j_863638,3,Terminated,474252,474275,23,100,0.39
task_ODg3NTU4NTE3NDcxODA4NjA5Ng==,21,j_656161,3,Terminated,517456,517524,68,100,0.39
task_LTg0MTUwNTA5Mjg4MDkwNjIzMA==,10,j_287918,10,Terminated,647060,647101,41,100,0.1
task_LTg0MTUwNTA5Mjg4MDkwNjIzMA==,44,j_678991,10,Terminated,560663,560692,29,100,0.1
task_LTg0MTUwNTA5Mjg4MDkwNjIzMA==,89,j_136936,10,Terminated,128665,128699,34,100,0.1
task_LTg0MTUwNTA5Mjg4MDkwNjIzMA==,20,j_211658,10,Terminated,323067,323106,39,100,0.1
task_LTg0MTUwNTA5Mjg4MDkwNjIzMA==,31,j_113638,10,Terminated,474272,474297,25,100,0.1
task_LTg0MTUwNTA5Mjg4MDkwNjIzMA==,13,j_215558,10,Terminated,215081,215120,39,100,0.1
task_LTg0MTUwNTA5Mjg4MDkwNjIzMA==,35,j_396689,10,Terminated,301483,301518,35,100,0.1
task_LTg0MTUwNTA5Mjg4MDkwNjIzMA==,17,j_623532,10,Terminated,323092,323120,28,100,0.1
task_LTg0MTUwNTA5Mjg4MDkwNjIzMA==,96,j_566830,10,Terminated,215093,215126,33,100,0.1
task_LTg0MTUwNTA5Mjg4MDkwNjIzMA==,30,j_578437,10,Terminated,128696,128730,34,100,0.1
task_LTg0MTUwNTA5Mjg4MDkwNjIzMA==,28,j_749351,10,Terminated,128728,128761,33,100,0.1
task_LTg0MTUwNTA5Mjg4MDkwNjIzMA==,17,j_799492,10,Terminated,323145,323169,24,100,0.1
task_LTg0MTUwNTA5Mjg4MDkwNjIzMA==,11,j_511164,10,Terminated,647153,647201,48,100,0.1
task_LTg0MTUwNTA5Mjg4MDkwNjIzMA==,15,j_476924,10,Terminated,560760,560786,26,100,0.1
task_LTg0MTUwNTA5Mjg4MDkwNjIzMA==,54,j_456034,10,Terminated,128766,128824,58,100,0.1
task_LTg0MTUwNTA5Mjg4MDkwNjIzMA==,17,j_404488,10,Terminated,323181,323206,25,100,0.1
task_LTg0MTUwNTA5Mjg4MDkwNjIzMA==,21,j_600464,10,Terminated,560782,560813,31,100,0.1
task_LTg0MTUwNTA5Mjg4MDkwNjIzMA==,12,j_526831,10,Terminated,301593,301640,47,100,0.1
task_LTg0MTUwNTA5Mjg4MDkwNjIzMA==,17,j_4332,10,Terminated,323206,323229,23,100,0.1
task_LTg0MTUwNTA5Mjg4MDkwNjIzMA==,13,j_12209,10,Terminated,582417,582445,28,100,0.1
task_LTg0MTUwNTA5Mjg4MDkwNjIzMA==,30,j_477944,10,Terminated,128824,128865,41,100,0.1
task_LTg0MTUwNTA5Mjg4MDkwNjIzMA==,27,j_550321,10,Terminated,215235,215279,44,100,0.1
task_LTg0MTUwNTA5Mjg4MDkwNjIzMA==,11,j_474933,10,Terminated,474440,474466,26,100,0.1
task_LTg0MTUwNTA5Mjg4MDkwNjIzMA==,11,j_607488,10,Terminated,474442,474488,46,100,0.1
task_LTg0MTUwNTA5Mjg4MDkwNjIzMA==,10,j_131694,10,Terminated,560847,560897,50,100,0.1
task_LTg0MTUwNTA5Mjg4MDkwNjIzMA==,12,j_827383,10,Terminated,582449,582488,39,100,0.1
task_LTg0MTUwNTA5Mjg4MDkwNjIzMA==,54,j_718932,10,Terminated,128852,128895,43,100,0.1
task_LTg0MTUwNTA5Mjg4MDkwNjIzMA==,11,j_461552,8,Terminated,452853,452894,41,100,0.1
task_LTg0MTUwNTA5Mjg4MDkwNjIzMA==,21,j_884303,10,Terminated,215269,215328,59,100,0.1
task_LTg0MTUwNTA5Mjg4MDkwNjIzMA==,24,j_504578,10,Terminated,128904,128949,45,100,0.1
task_LTg0MTUwNTA5Mjg4MDkwNjIzMA==,34,j_605276,10,Terminated,647307,647334,27,100,0.1
task_LTg0MTUwNTA5Mjg4MDkwNjIzMA==,29,j_183447,10,Terminated,647311,647343,32,100,0.1
task_LTg0MTUwNTA5Mjg4MDkwNjIzMA==,41,j_476802,10,Terminated,301713,301755,42,100,0.1
task_LTg0MTUwNTA5Mjg4MDkwNjIzMA==,40,j_156065,10,Terminated,647320,647350,30,100,0.1
task_NzQ3MjEzNzg0MzE5NDE5NzM1Mg==,24,j_262157,3,Terminated,539328,539430,102,100,1.53
task_LTg0MTUwNTA5Mjg4MDkwNjIzMA==,18,j_231894,10,Terminated,560934,560985,51,100,0.1
task_LTg0MTUwNTA5Mjg4MDkwNjIzMA==,12,j_215553,10,Terminated,128953,129140,187,75,0.1
task_MzQwMDQzNjY0MzkwNzU2ODYyMg==,39,j_651227,3,Terminated,539355,539403,48,100,0.39
task_LTg0MTUwNTA5Mjg4MDkwNjIzMA==,79,j_142411,10,Terminated,474562,474588,26,100,0.1
task_LTg0MTUwNTA5Mjg4MDkwNjIzMA==,17,j_446263,10,Terminated,560971,561007,36,100,0.1
task_MzQwMDQzNjY0MzkwNzU2ODYyMg==,19,j_240769,3,Terminated,193781,193814,33,100,0.39
task_LTg0MTUwNTA5Mjg4MDkwNjIzMA==,37,j_21246,10,Terminated,474583,474609,26,100,0.1
task_LTg0MTUwNTA5Mjg4MDkwNjIzMA==,32,j_291933,10,Terminated,474586,474620,34,100,0.1
task_LTg0MTUwNTA5Mjg4MDkwNjIzMA==,33,j_471031,10,Terminated,496196,496219,23,100,0.1
task_LTg0MTUwNTA5Mjg4MDkwNjIzMA==,29,j_277364,10,Terminated,647399,647441,42,100,0.1
task_LTg0MTUwNTA5Mjg4MDkwNjIzMA==,26,j_22609,10,Terminated,496200,496234,34,100,0.1
task_LTg0MTUwNTA5Mjg4MDkwNjIzMA==,19,j_470339,10,Terminated,561005,561038,33,100,0.1
task_LTg0MTUwNTA5Mjg4MDkwNjIzMA==,79,j_598795,10,Terminated,215408,215457,49,100,0.1
task_LTg0MTUwNTA5Mjg4MDkwNjIzMA==,27,j_109695,10,Terminated,129033,129164,131,75,0.1
task_LTg0MTUwNTA5Mjg4MDkwNjIzMA==,81,j_630326,10,Terminated,215435,215505,70,100,0.1
task_LTg0MTUwNTA5Mjg4MDkwNjIzMA==,26,j_754452,10,Terminated,129043,129220,177,75,0.1
task_LTg0MTUwNTA5Mjg4MDkwNjIzMA==,28,j_100040,10,Terminated,129048,129118,70,100,0.1
task_LTg0MTUwNTA5Mjg4MDkwNjIzMA==,20,j_381902,10,Terminated,561066,561114,48,100,0.1
task_LTg0MTUwNTA5Mjg4MDkwNjIzMA==,15,j_51678,10,Terminated,129085,129267,182,75,0.1
task_LTg0MTUwNTA5Mjg4MDkwNjIzMA==,12,j_120705,10,Terminated,129097,129266,169,75,0.1
task_LTg0MTUwNTA5Mjg4MDkwNjIzMA==,70,j_572991,10,Terminated,129106,129146,40,100,0.1
task_LTg0MTUwNTA5Mjg4MDkwNjIzMA==,70,j_179820,10,Terminated,561121,561150,29,100,0.1
task_LTg0MTUwNTA5Mjg4MDkwNjIzMA==,21,j_309431,10,Terminated,561146,561174,28,100,0.1
task_LTg0MTUwNTA5Mjg4MDkwNjIzMA==,27,j_758291,10,Terminated,129148,129183,35,100,0.1
task_ODg3NTU4NTE3NDcxODA4NjA5Ng==,32,j_218592,3,Terminated,280361,280394,33,100,0.39
task_LTI0MjU2NDM0NTE3NDI0MzkwNjE=,20,j_848153,3,Terminated,237163,237208,45,100,0.39
task_LTg0MTUwNTA5Mjg4MDkwNjIzMA==,10,j_301555,8,Terminated,107568,107611,43,100,0.1
task_LTI0MjU2NDM0NTE3NDI0MzkwNjE=,10,j_748877,3,Terminated,669172,669199,27,100,0.39
task_LTg0MTUwNTA5Mjg4MDkwNjIzMA==,23,j_779249,10,Terminated,129177,129213,36,100,0.1
task_LTg0MTUwNTA5Mjg4MDkwNjIzMA==,14,j_218978,10,Terminated,129177,129355,178,75,0.1
task_LTg0MTUwNTA5Mjg4MDkwNjIzMA==,13,j_640633,10,Terminated,582785,582817,32,100,0.1
task_LTg0MTUwNTA5Mjg4MDkwNjIzMA==,21,j_31998,10,Terminated,561189,561223,34,100,0.1
task_LTg0MTUwNTA5Mjg4MDkwNjIzMA==,12,j_665484,10,Terminated,150792,150814,22,100,0.1
task_LTg0MTUwNTA5Mjg4MDkwNjIzMA==,33,j_807007,10,Terminated,129207,129230,23,100,0.1
task_LTg0MTUwNTA5Mjg4MDkwNjIzMA==,29,j_586980,10,Terminated,302009,302046,37,100,0.1
task_LTg0MTUwNTA5Mjg4MDkwNjIzMA==,19,j_88649,10,Terminated,561220,561249,29,100,0.1
task_LTg0MTUwNTA5Mjg4MDkwNjIzMA==,10,j_284927,8,Terminated,539657,539680,23,100,0.1
task_LTg0MTUwNTA5Mjg4MDkwNjIzMA==,28,j_432115,10,Terminated,474860,474893,33,100,0.1
task_LTg0MTUwNTA5Mjg4MDkwNjIzMA==,18,j_866806,10,Terminated,129269,129293,24,100,0.1
task_LTg0MTUwNTA5Mjg4MDkwNjIzMA==,23,j_251934,10,Terminated,302071,302123,52,100,0.1
task_LTI0MjU2NDM0NTE3NDI0MzkwNjE=,26,j_838432,3,Terminated,474872,474911,39,100,0.39
task_LTg0MTUwNTA5Mjg4MDkwNjIzMA==,36,j_876667,10,Terminated,561272,561331,59,100,0.1
task_LTg0MTUwNTA5Mjg4MDkwNjIzMA==,21,j_826740,10,Terminated,302074,302104,30,100,0.1
task_LTg0MTUwNTA5Mjg4MDkwNjIzMA==,21,j_254871,10,Terminated,561290,561351,61,100,0.1
task_LTg0MTUwNTA5Mjg4MDkwNjIzMA==,13,j_203092,10,Terminated,582905,582933,28,100,0.1
task_LTg0MTUwNTA5Mjg4MDkwNjIzMA==,24,j_380640,10,Terminated,561327,561393,66,100,0.1
task_LTg0MTUwNTA5Mjg4MDkwNjIzMA==,23,j_616250,10,Terminated,669365,669387,22,100,0.1
task_LTg0MTUwNTA5Mjg4MDkwNjIzMA==,39,j_409036,10,Terminated,215767,215799,32,100,0.1
task_MzQwMDQzNjY0MzkwNzU2ODYyMg==,24,j_385692,3,Terminated,539775,539808,33,100,0.39
task_LTI0MjU2NDM0NTE3NDI0MzkwNjE=,24,j_385692,3,Terminated,539775,539838,63,100,0.39
task_LTg0MTUwNTA5Mjg4MDkwNjIzMA==,22,j_176586,10,Terminated,302177,302205,28,100,0.1
task_LTg0MTUwNTA5Mjg4MDkwNjIzMA==,70,j_640676,10,Terminated,302179,302218,39,100,0.1
task_LTg0MTUwNTA5Mjg4MDkwNjIzMA==,24,j_821899,10,Terminated,129384,129412,28,100,0.1
task_LTg0MTUwNTA5Mjg4MDkwNjIzMA==,38,j_172701,10,Terminated,474987,475010,23,100,0.1
task_LTg0MTUwNTA5Mjg4MDkwNjIzMA==,12,j_686770,10,Terminated,669407,669431,24,100,0.1
task_LTg0MTUwNTA5Mjg4MDkwNjIzMA==,24,j_665076,10,Terminated,302222,302251,29,100,0.1
task_LTg0MTUwNTA5Mjg4MDkwNjIzMA==,78,j_777553,10,Terminated,561432,561462,30,100,0.1
task_LTg0MTUwNTA5Mjg4MDkwNjIzMA==,17,j_545289,10,Terminated,129433,129460,27,100,0.1
task_MzQwMDQzNjY0MzkwNzU2ODYyMg==,27,j_623804,3,Terminated,194257,194299,42,100,0.39
task_LTg0MTUwNTA5Mjg4MDkwNjIzMA==,43,j_788948,10,Terminated,561465,561491,26,100,0.1
task_LTg0MTUwNTA5Mjg4MDkwNjIzMA==,91,j_688134,10,Terminated,561471,561498,27,100,0.1
task_LTg0MTUwNTA5Mjg4MDkwNjIzMA==,11,j_660872,10,Terminated,151074,151105,31,100,0.1
task_MzQwMDQzNjY0MzkwNzU2ODYyMg==,32,j_379451,3,Terminated,583096,583158,62,100,0.19
task_LTg0MTUwNTA5Mjg4MDkwNjIzMA==,18,j_868242,10,Terminated,561497,561518,21,100,0.1
task_MzQwMDQzNjY0MzkwNzU2ODYyMg==,35,j_232548,3,Terminated,583097,583123,26,100,0.19
task_LTg0MTUwNTA5Mjg4MDkwNjIzMA==,21,j_423266,10,Terminated,302314,302334,20,100,0.1
task_LTg0MTUwNTA5Mjg4MDkwNjIzMA==,25,j_593945,10,Terminated,647914,647940,26,100,0.1
task_ODg3NTU4NTE3NDcxODA4NjA5Ng==,23,j_444993,3,Terminated,280724,280781,57,100,0.39
task_LTg0MTUwNTA5Mjg4MDkwNjIzMA==,19,j_95988,10,Terminated,561535,561562,27,100,0.1
task_LTg0MTUwNTA5Mjg4MDkwNjIzMA==,21,j_430402,10,Terminated,302341,302364,23,100,0.1
task_LTg0MTUwNTA5Mjg4MDkwNjIzMA==,80,j_629042,10,Terminated,215946,216022,76,100,0.1
task_LTg0MTUwNTA5Mjg4MDkwNjIzMA==,19,j_768279,10,Terminated,561549,561592,43,100,0.1
task_LTg0MTUwNTA5Mjg4MDkwNjIzMA==,18,j_902314,10,Terminated,561550,561595,45,100,0.1
task_LTg0MTUwNTA5Mjg4MDkwNjIzMA==,13,j_812983,10,Terminated,583151,583181,30,100,0.1
task_LTg0MTUwNTA5Mjg4MDkwNjIzMA==,85,j_623577,10,Terminated,475172,475197,25,100,0.1
task_LTg0MTUwNTA5Mjg4MDkwNjIzMA==,39,j_365983,10,Terminated,215973,216009,36,100,0.1
task_LTg0MTUwNTA5Mjg4MDkwNjIzMA==,20,j_815662,10,Terminated,561575,561601,26,100,0.1
task_LTg0MTUwNTA5Mjg4MDkwNjIzMA==,17,j_222286,8,Terminated,194376,194443,67,100,0.1
task_LTg0MTUwNTA5Mjg4MDkwNjIzMA==,23,j_311904,10,Terminated,302385,302407,22,100,0.1
task_LTg0MTUwNTA5Mjg4MDkwNjIzMA==,24,j_859969,10,Terminated,561596,561644,48,100,0.1
task_LTg0MTUwNTA5Mjg4MDkwNjIzMA==,70,j_395833,10,Terminated,129599,129639,40,100,0.1
